毒販槍自抵太陽穴與警對峙1小時	society
土城鵝肉名店遭縱火1死4傷	society
刑事局前主秘╱許瑞山包庇賭場二審逆轉判3年4月	society
行政契約協商若無結果林峯正：婦聯會資產將被凍結	politics
陽岱鋼談基層棒球：禮節比技術重要10倍	sports
勇士換戲碼「浪花兄弟」險翻船	sports
義氣！侯貞雄捐錢捐鋼蓋台大社科院免冠名	business
冬盟》首場無四死球完封朴峻杓暫居雙冠王	sports
民進黨布局2020英德配？清邁配？	politics
百敗翻身奪外卡最佳總教練落雙城	sports
黑道勾統促黨／四海幫中常委暴力喬1600萬分手費	society
糊塗爸亂放打火機4歲娃燒屋	society
記憶體價量齊揚金士頓今年營收上看百億美元	business
姊逼弟試喝套出保力達Ｂ摻農藥	society
4連亞雖然苦澀恰恰看見未來	sports
NBA黑人版高富帥違抗父命闖出一片天	sports
競逐檢察總長5人選大熱門顏大和明年五月卸任蔡總統擬明年三月提名繼任人選	politics
婦聯會拖字訣立委︰政府不應讓步	politics
老師：代管學生物品	society
幼女哭鬧被罵父砸人還到醫院堵人	society
原民自治區長屬民選任期4年	society
男大生不知遇詐騙拉室友取款都上當	society
「棒球是一生志業」蔣智賢提告	sports
治恐怖情人警署力推糾纏行為防制法	society
活塞、金塊崛起擠身前3強	sports
共機又近台今年第16起	politics
UBA》李家慷換跑道國體大勝屏大	sports
威力盃少棒賽20隊參賽創新高	sports
《國際現場》Google翻臉YouTube從亞馬遜設備撤下	business
賣龍潭廠與周邊用地味全Q4入帳	business
警官違規暴走飆小警網民酸「好大的官威」	society
工商界：經濟要轉骨速解決5缺	business
哈登大三元打跑騎士	sports
法人董事人數比例金管會擬修法規範	business
清晨4點就穿好球衣太巴塱球員超嗨	sports
中信冰風暴延燒曾仁和籲別亂猜	sports
李家慷挑戰SBL南山教練︰大學課業為重	sports
上回…手銬男求助警這次…偷車真的被銬	society
「操」人詹姆斯捕蜂3連勝	sports
中國伸黑手阻我出席聯合國氣候會議	politics
不跟進打澳聯林煜清還在等消息	sports
中廣案黨產會12.21開聽證會	politics
世桌年終賽》台奶爸組合四強戰抗日	sports
塞揚誰屬？美聯沒意外、國聯有懸念	sports
矽卡惡火6死／工業區鐵皮宿舍無人檢舉查報死角	society
受害家屬心聲：能遏止「可教化」成擋箭牌嗎?	society
新聞分析》宋習會預測	politics
已還陳鴻文清白?士檢指認知有落差	sports
世界盃資格賽》今晚戰狂「菲」台灣客場拚開胡	sports
WTA台灣公開賽李亞軒喜獲外卡	sports
柯瑞帶傷上轟30分滅「火」	sports
台新銀愛的力量127個團體獲獎	business
明年資本預算達192億矽品擴增DRAM封測	business
韋蘭德明完婚恐缺席今封王遊行	sports
推美台軍事交流美眾議員提「台灣安全法」	politics
大聯盟總經理會議搶標大谷、史坦頓	sports
婦聯會案今簽行政契約備忘錄	politics
社會人助攻中職闖冬盟季後賽	sports
書劍集》國際貿易的事實與現實	business
「球哥」變髮換不回手感	sports
周儀翔西進張家榮扛達欣一哥？	sports
拉同學賭輸376萬劣警還抽佣幫組頭逼債	society
立院廢止蒙藏會組織法	politics
中製監視器入侵美國被看光	business
《國際現場》聯想取得FCCL過半股權	business
台灣大賽沒cue他林樺慶：隊友太強	sports
酒駕累犯處鞭刑?賴揆︰須廣泛討論	society
害21醫師急墜25樓電梯公司判賠1004萬	society
兩個教練對決王維中覺得有趣	sports
UBA》放棄比賽惹議台師大教頭一肩扛	sports
智退暴露狂冷靜蒐證別慌	society
曾祥鈞合影運動正妹「笑不出來」	sports
宮廟主委自轟亡子彈穿心後卡牆	society
中批我國防報告書╱陸委會促中國擺脫霸道心態	politics
世界新車大展12.30開跑連9天尬車	business
9度判死徐自強關16年獲冤賠	society
主將「出國征戰」裕隆、璞園遭狙擊	sports
棒球返2020東奧我備戰不能等	sports
金錢豹酒女撞死烘焙師傅第三任丈夫：她為錢當酒女罪有應得	society
未注意前方車禍國道5連撞釀6傷	society
HBL／泰山整門面冒出最萌平頭男	sports
《財經觀測站》蘋果被人看光光	business
星期專論》台灣原本是語言的萬花筒	politics
台日青棒賽》首局挖大洞高苑苦追落敗	sports
昆山傳祭停產令台股驚跌百點分析師︰不必自己嚇自己	business
林祐樂從零開始「捕」捉細節	sports
16歲助家計打工遇劫賠償、療傷…父悲從中來	society
舞小姐被包2週走「騙」全台當車手	society
小小軸承缺不得足以撼動中國汽車業	business
中國工資上漲加缺料和碩Q3毛利3.4%創新低	business
5年婚姻破局小嫻、何守正驚爆離婚	sports
李明哲案將宣判李凈瑜明赴中	politics
亞冠賽》陽隊長透露敵情開「備忘錄」	sports
台灣巴拉圭經濟合作協定三讀	politics
台灣大賽》最鮮肉的一轟小阿飛8打點驚奇	sports
NBA》53年沒辦明星賽綠衫軍考慮出「爭」	sports
台灣犬商品大賣中職也訝異	sports
「投」葉總所好陳仕朋開季先發候選人	sports
炫槍走火中彈誆遭槍擊被抓包	society
保羅31分上太空哈登場下開心看	sports
電競世錦賽台灣搶下主辦權	sports
「可以摸一下嗎?」海倫清桃控男粉絲藉合照襲胸	society
屋外供友埋毒物轟！房子車子燒光	society
MVP加持軟銀洋投沙法提「三冠王」	sports
一週證券行情表、一週櫃檯行情表	business
埔里巨石砸車鄉代媳婦撞山壁枉死	society
高志綱惋惜沒山谷可甩桿	sports
北市仲介公會：明年房市價跌量微增	business
血洗彰中日警如臨大敵	society
升息機會低澳元與澳公債投資降溫	business
威力彩頭獎連20摃	society
慶富案》副總長兼執行官陳寶餘：軍方若違法我退伍	politics
佈局新南向中鋼大收割	business
新護照竟有美機場圖外交部致歉重印	politics
中國明年開徵環保稅企業成本大增	business
易中毒釀火災燒炭取暖最危險	society
新南向再告捷台菲保險MOU簽了	business
NBA》爵士菜鳥米契爾轟41分助勝	sports
美貿易代表批WTO：對中國太寬容	business
香港羽球超級賽》戴資穎晉8王子維惜敗諶龍	sports
騎士12連勝魏德「退位」最關鍵	sports
300毛孩遭吃剩骨頭懸賞10萬緝凶	society
共機又來亂F-16升空監控	politics
嘉南夾娃娃高手原來是萬磁王作弊	society
去年政治獻金收入民進黨居冠	politics
林智勝打破沉默絕不負辜董所託	sports
Q3高掛佳績氣動元件Q4續揚	business
馬刺落井下石艾德瑞吉41分K熊	sports
《新聞幕後》移轉管轄的笑話	politics
4隊搶史坦頓洋基組「賈史」連線？	sports
上市櫃起薪大學畢平均三萬元	business
柏騰主打真空濺鍍搶進車輪客製化設計	business
盧曉晴4冠背後…是肩痛的煎熬	sports
台積電將斥資1298億建廠擴產能	business
軍人年改朝向有利現役人員	politics
勞動部微型創業鳳凰助1.7萬人圓夢	business
客戶外移再生前3季獲利腰斬	business
友達以上戀人已滿！放閃男女判賠心碎夫30萬	society
台彩威力盃》冠軍戰亮點竹市四爺對台東一哥	sports
無罪可聲請冤賠最高可獲14萬5千元	society
新聞分析》民眾參與協會加溫體改初見成效	sports
白宮官員：台灣民主在印太地區極重要	politics
男當街揮刀自殘企圖切腹警壓制	society
火腿邀桃猿交流賽最佳陣容應戰	sports
跨年聚餐老闆撿屍女員工	society
SBL》蘇奕晉滿載25分金酒逆轉達欣	sports
反制共機擾台美學者促售台空中加油機	politics
與慶富打官司軍方準備好了	politics
李婉鈺又傳斷片鬧事打人襲警交保嗆告警	society
惡男率幫眾討債電擊火烤逼吃屎	society
創新低紀錄╱特殊號碼鈔券退燒?單筆最高得標價僅11萬	business
美國拒承認中國市場經濟地位	business
NBA》庫茲馬技壓球哥將成湖人救世主？	sports
林德福︰未喬會員、理事黃國昌︰公然說謊	sports
工業宅違規套房大火燒死7旬翁	society
200員工轉調新廠茂迪︰非裁員	business
180萬工人下崗中國爆20年最大裁員潮	business
陳宣銘涉吸金52億從印尼押解回台	society
國巨第四度調高報價全年EPS挑戰15元	business
將官晉任31人侍衛長張捷升中將	politics
國銀海外分行爽賺就怕出包	business
彭誠浩當選WBSC副會長盼U12永固台灣	sports
林志祥自請離隊下一步崇越?	sports
進門就開轟警指銀行無從應變	society
台僑替詐團張羅機房每處月費2萬美元	society
富二代難忍坐牢蛀牙聲請保外被駁	society
中方指責阻撓曾永權赴中陸委會回嗆不容無理干涉	politics
打球沒出息感觸深陳偉殷交心學弟	sports
台灣國際衝浪公開賽世界冠軍參戰	sports
助慶富「持有」用地？高市海洋局澄清	politics
419反年改施暴案再起訴黃耀南等3人	politics
NBA》大三元連3刷大帝自評還不夠	sports
慶富案追究刑責立委促查公股銀行	politics
《國際現場》Mozilla棄雅虎擁抱Google	business
累了不告了吳經國辭拳總主席	sports
SBL》台啤主場週首日戰績開紅、票房收黑	sports
調查局首位女副座穿越車陣被撞傷	society
中和大火扣押4戶約談前房東	society
中國經商環境惡化逾半德企不想再投資	business
日諧星另類情蒐猿推薦60號拚場	sports
曾共舔一支冰淇淋╱夜找碩文堅稱兄妹情	society
Q3每股虧損3.8元宏達電連10虧	business
開車拖出地下電纜偷3公里長	society
前進大東南亞跳板以國首邀台企參訪	business
M.加索「被冰」氣噗噗灰熊8連敗	sports
費城人宣布新主帥上原聽了有感	sports
中信盃今開打辜董強調態度紀律	sports
婦自摔躺地板16小時夫有預感越洋電話救人	society
鐵鎚斷5人手腳蘇治芬：前縣長司機帶頭	society
外籍女掉包偷走62萬元勞力士錶	society
海碩盃女網賽》戈盧比克晉4強對決「辛吉絲接班人」	sports
南英OB賽神秘嘉賓不輸恰恰鋒哥	sports
載癌母才放慢雪隧龜速車7分鐘吞5罰單	society
中信盃棒球賽落幕新竹縣雙冠王	sports
第3節之王！勇士單節贏32分平紀錄	sports
中和大火／省錢孝親警住違建枉送命	society
弱勢盤整台幣小貶1.5分	business
塞爾、金布瑞紅襪續留雙強投	sports
中信領隊：我無法指控任何人打假球	sports
開賓士住高鐵特區酒女撞死主廚「沒錢賠」	society
吳密察：促轉不是為了報復是為了和解	politics
台灣百萬美元富豪38萬人全球第13	business
世界盃亞洲區資格賽》台灣男籃週五打澳Q.戴維斯回歸	sports
房客在置物櫃放針孔旅店員工偷翻全都錄	society
美歐日聯手抗中國不公平貿易	business
球迷挺大師兄：不可能做那些事	sports
SBL》賈西亞攻破布拉台銀賞達欣連敗	sports
舔耳強吻女職員前財部高官判刑	society
立委促修法「沒收銀行不法所得」顧立雄︰研議可行性與必要性	business
參觀馬紹爾手工藝品展蔡笑稱很久沒逛街	politics
中國房市泡沫欲破馮侖來台蓋養生村	business
SBL熱身賽》這回玩真的塞勒扛住布拉	sports
日月光控股公司明年五月設立	business
最狂警民合作！飲料店老闆飛撲助警逮毒蟲	society
星期專論》為余光中蓋棺論定	politics
博通若成巨獸衝擊聯發科、瑞昱	business
立院三讀輕罪可上訴至三審	society
日職》呂彥青首要增重陳冠宇要他多問	sports
強化空優專家主張先爭取新一代戰機	politics
王躍霖強調基本功叮嚀練下盤	sports
迷戀按摩師恐怖客人自殘求愛	society
中職》兄弟「30人名單」年後赴美春訓	sports
姦殺原本唯一死刑修法後明顯輕判	society
警逮娃娃機大盜64公斤硬幣搬到手軟	society
辜董再解釋…「前一天也不該喝酒」	sports
再添雙胞胎盧彥勳為3兒拚東奧	sports
ATP年終賽》迪米特洛夫晉4保加利亞第一人	sports
立院三讀／脅迫兒少陪酒最重判5年	society
管媽怒批「還要再劃幾刀？」	politics
稅金吃掉3成租金雙子星案恐難脫標	business
新書揭抗癌歷程邱議瑩：我終生不孕	politics
房市注活水金管會調降房貸風險權數	business
高雄最貴豪宅國硯首見法拍屋	business
比特幣一度升破1.5萬美元葛林斯潘︰恐變一文不值	business
美評估軍艦互訪我樂見其成	politics
冬盟》連兩場4棒+蹲捕狀「猿」廖健富學抗壓	sports
律師開房「談案情」妻隔牆埋伏抓包	society
精神病患個管師不足衛福部擬年增百名	society
日教練不教基本柳田透露長打秘訣	sports
火箭「雙核心」轟10顆三分彈	sports
世界盃資格賽》我今主場戰澳盡全力拚贏	sports
亞洲盃資格賽》台土大戰前夕周定洋趕赴前線	sports
2.5億珠寶竊案11嫌贓物當晚離台	society
《一次比一次誇張》試槍狂人曾替乾女兒毆舊愛	society
「純本土」對決台啤賞「衛冕軍」2連敗	sports
川普會習近平：美不會終止對台軍售	politics
所長調職未帶走職章易遭亂蓋	society
出包補習班將加強稽查	society
兩車相撞車翻覆民眾合力救人	society
慶富7億餘還款保證金繳庫	politics
控同事襲胸當庭扯怪物摸奶	society
哥哥是明星清宮福太郎來台	sports
搶進人工智慧領域鈺創首創「3D自然光視覺」技術	business
威力盃》台東備四彩球衣冠軍戰「撞色」	sports
中國水泥庫存降低台泥兩廣地區喊漲	business
漢翔訂單能見度看到2022年	business
火腿放手大谷圓美夢	sports
證券行情表、證券表格	business
警專被爆醫務室沒醫生學生昏迷不准打119	society
下週川習會小英：審慎樂觀	politics
提前超標新南向工程今年上看240億	politics
旅遊也能租復康巴士難防濫用	society
針對台灣中國調查正丁醇傾銷	business
兩個哥哥旅美張偉聖暫不跟進	sports
小女友要分手渣男性侵還拍過程	society
下週油價估跌一角	business
黃金單身漢送報起家拚掉婚姻	society
三ＧＷ遴選以國產化程度評分風電業者：恐成作文比賽	business
《謠言終結站》	politics
詐騙車手輸錯密碼帳戶6720萬只領84萬	society
將會見達比修雙城王牌虛位以待	sports
世亞盟曾無償佔用國有地40年	politics
納智捷新車加持明年銷售估逾兩萬台	business
立委：陳慶男該把資金流向說清楚	politics
ACE冥冥中保佑大谷宣布挑戰大聯盟	sports
MSCI新兵如興今年營收拚百億	business
談兄弟風波殷仔：球迷期望高、做該做的事	sports
盼李明哲早歸民眾繫上黃絲帶	politics
基隆客運國道翻車撞斷燈桿8乘客傷	society
一週大事（12月10日至16日）	politics
摘「新」感言詹子賢想催淚失敗	sports
美批中國扭曲經濟拒授市場經濟地位	business
公車司機昏厥撞騎樓火燒車	society
冬盟》李帶溵處女秀預計主投3場	sports
台日韓啦啦隊先開戰場邊最大「嬌點」	sports
彰化縣長選戰》搞黑道大整合？藍綠隔空交火	politics
幻象人機失聯／馮世寬爆粗口斥飛官投共說	politics
跨年作業自畫生殖器！馬公高中惹議校長急喊卡	politics
黑豹旗4強今割喉再延賽就轉戰台中	sports
首批升級4架F-16V明年初試飛	politics
《國際現場》美滿電子將收購凱為半導體	business
罰高通不傷產業？杜紫宸︰荒腔走板	business
學者︰吸引企業投資才能改善薪情	business
蔣智賢轉「職」成功澳職大肆宣傳	sports
亞冠賽》1安2保送王柏融擺脫低潮	sports
中化銀髮賠錢12年堅持照護人才培訓	business
張安平改造老台泥轉型綠色產業國際公司	business
操守染黑？林煜清聲明2連發	sports
供稱每2、3天就動粗…虐死紙片女狠父收押	society
殺警案15人被求償千萬易淑寬之子求分期	society
太陽能廠三合一案洪傳獻︰按程序進行中	business
2017倫敦年終賽》葛芬專殺名將費爸無緣鍍金	sports
國際品牌進駐北市東區店面	business
假炒匯真吸金環工畢業生騙逾6千	society
遠銀遇駭有四大缺失金管會開罰800萬	business
打破鳥籠公投公投法今拚三讀	politics
各國嚴審中企海外併購銳減1/3	business
比特幣挖礦難度倍增映泰:訂單能見度僅1個月	business
今彩539頭獎1注中	society
YY棒球訓練營》美式守備方式王勝偉師法	sports
身兼中纖老闆╱排協理事長被爆要員工當人頭會員	sports
亞冠賽》大王商品熱賣台式應援首攻蛋	sports
「豪哥」頻轟出牆日媒驚問「那是誰?」	sports
去年520後未再從中國接返受刑人	politics
KOBE傳奇「高掛」退休2球衣	sports
中職稀貨黃子鵬連兩戰「秀肌肉」	sports
黑豹旗／一舉投到封王古林睿煬無憾	sports
台土大戰後防失誤無緣亞洲盃	sports
嫩男扮國中女生2度混進學校女廁	society
張善政：一例一休仍用製造業思維	business
小天不敵球王「送分」插曲有戲	sports
監控人民中砸錢挺臉部辨識	business
iPhoneQ4整體出貨上攻8880萬支	business
傳國民黨屬意蔣萬安選北市長鄭麗文︰不該讓「小朋友」去打仗	politics
台新金續找併購標的	business
山口茜拍掉依瑟儂闖進「年終」冠軍戰	sports
YY棒球訓練營》張育成明年目標：拚上大聯盟	sports
雙11電信業績佳台灣大獨推雙12	business
CPR連線難擋厄文甩尾綠衫軍7連勝	sports
選新北？李四川：躲到床下還是中槍	politics
廣越、光隆明年Q1不看淡	business
永豐金弊案前元太科董座起訴	business
找老公掃墓開門赫見小三沒穿內褲	society
蔣經國認證團徽鑲的是黨徽	politics
年底清倉24人林英傑無「猿」的結局	sports
期待正義彭劉懸案催生新法	society
灌溉水量有點少…驚見女屍堵出水口	society
百億投大潭電廠供電添生力軍	business
文大四劍客底氣足包了3至6棒	sports
母時薪40元嫩兒被騙盜領36萬血汗錢	society
前3季獲利超過去年朋億明年營運估增1至2成	business
「洋蔥網路」駭Vidol影音三立前員工起訴	society
傑尼「獅」月薪漲幅100％起跳	sports
《財經觀測站》行動支付普及面臨3大難關	business
推動中正紀念堂轉型鄭麗君：繼續追思威權者是人格分裂	politics
桃園「7帥」督軍不敢操過頭	sports
聲寶今年營收恐衰退1成	business
停武嶺誤踩油門衝出護欄車懸空	society
獵雷艦懲處名單國防部暫緩公布	politics
週刊爆「排擠效應」說恰恰不隨之起舞	sports
失焦的典禮「聯盟該讓事件落幕」	sports
狂過比特幣以太幣今年暴漲50倍	business
《本週熱點》「五缺」問題賴清德將公布解決方案	business
婦聯會是否簽行政契約今須給答案	politics
足協國際邀請賽》3戰進4球李茂踢走4年低潮	sports
威力彩頭獎連19摃	society
碩士狼父性侵還拍裸照傳雲端	society
冬盟》吉田凌5局7K日職西軍第5	sports
柯瑞繃帶纏身加班變身電湖人	sports
中和大火9死房東名下竟毫無房產	society
防偷開車進廠前先記里程數	society
扶植新創業者「台灣孵化器」中科揭牌	business
《謠言終結站》勞團抗爭沒有律師被逮捕	politics
ABL》衛冕軍踢館夢想家2連敗	sports
1.5億安毒原料闖關可毒害500萬人	society
女壘亞錦賽》台灣女壘今拚亞錦賽首冠	sports
判決確定個案將可進行釋憲	society
不倫戀／女助理流產挨告法官批老師始亂終棄	society
入圍「運動精英獎」世大運女籃意外	sports
台灣第一人！鄭兆村獲邀國際田聯頒獎禮	sports
《回味採紅菱》偷划輕艇台大夫妻翻船送辦跪哭窮	society
陳順詳「報恩」拚4000俱樂部	sports
友達：明年Q1訂單能見度仍高	business
U19亞足聯》主場像客場台1球輸越	sports
啃蘋果毛利壓力大鴻海、和碩、緯創腹瀉	business
判刑未到監莊婉均被簽發拘票	politics
小燈泡案家屬拒修復式司法	society
深化安全架構台美日下月三邊對話	politics
《真的好衰》車主︰修好也不敢開	society
股權選擇權1萬元買所有蘋概股	business
哈登神勇無極限火箭西霸天	sports
謠言終結站》AppleWatch3LTE版不能賣?NCC：無此規定	business
欠2000萬米店老闆自焚命危妻跳樓亡	society
亂摸2女兵空軍幻象基勤主官毀前程	society
獅隊第一個當阿公賴崇光、耿健輝別苗頭	sports
台日友好台企赴日投資成功率高	business
Uber司機須找車行掛名變相靠行沒賺頭	society
錯失旅日「四爺」活在當下	sports
安非他命成癮易變暴力男	society
理光盃》風中抓8鳥盧曉晴搶頭彩	sports
星期專論》川普立威與承認現實原則	politics
Q3獲利年減8成綠悅跌停	business
攜手AMD抗衡英特爾掀PC市場巨浪	business
世界盃資格賽》威廉狂砍20分菲驚險射日	sports
世界盃資格賽》6000球迷助陣我仍被澳客打趴	sports
東霸天兩樣情...厄文連勝穩一哥騎士連敗添傷兵	sports
國營事業新南向雙印、越南最夯	business
宋楚瑜母親辭世享嵩壽100歲	politics
公司法大翻修納洗錢防制條文	business
黃郁婷奪冬奧門票…要失眠了！	sports
徐總子弟兵現身3人3種心情	sports
換股轉敗為勝嘉泥︰不退出水泥行業	business
關島馬直奔波馬推台客獨享禮	sports
天降3噸巨石…10秒定生死2警逃一劫	society
冬盟》洪心騏挨3分砲不敵日職東軍	sports
聯亞Q3營收季增5成矽光訂單看到明年2月	business
喬治想贏魏少挺二度傷害老東家	sports
聯邦銀獲利穩定提高資本適足率	business
藏毒褲襠「鼓鼓的」遇盤查栽了	society
黑豹旗》林靖凱勝投+勝打平鎮晉4強	sports
強投何處覓》三級棒球盃賽多投手提前殞落	sports
業者吐苦水：月薪7萬請無人	society
豬隊友拚輸中韓5G恐提前出局	business
恐怖情人認錯人狂追無辜女轟6槍	society
台塑四寶11月業績佳12月更看好	business
海碩盃女網賽》術後強勢回歸班西琪「背靠背」奪冠	sports
小拳王下月挑戰總統盃魂斷山林	society
「我是大人了不能浪費警察資源」迷途「唐大人」溫暖人心	society
開啟時空膠囊美好記憶2師挨教務主任告竊盜	society
朗度無私25助攻刺激隊友狂飆分	sports
怕傷高官仕途南市警分局暗槓槍擊案	society
全國桌球錦標賽》搭檔陳建安「新手爸」江宏傑奪冠	sports
不談告週刊林泓育教蹲捕3基本	sports
國際現場》LGD擬砸40億美元擴產OLED面板	business
王勝偉情緒潰堤手寫稿代言	sports
李伊宣告退休下一步娶沃茲妮雅琪	sports
亞錦賽》林鳳珍開轟輸菲不樂	sports
加薪500％軟銀石川先還學貸	sports
國際現場》強化音樂識別領域蘋果收購Shazam	business
日立冷氣蟬聯理想品牌雙冠王	business
台英混血少女橘子盃女雙封后	sports
當眾伸鹹豬手摸5秒判90天	society
豪門卡登又掀波二少東駕名車持毒被捕	society
台幣升逾4年新高「明年回貶機率高」	business
國際特赦組織︰熱比婭30親戚遭中拘捕	politics
少校退役妙天自創印心禪成大師	society
中和大火／唯一逃生口陷火海7大缺失阻生路	society
台灣3戰全輸「大王」罕見低潮	sports
勞團上街工商界：不代表多數勞工	business
《謠言終結站》	politics
揪團去爬嘉明湖廂型車逆向撞貨車8傷	society
傷25人╱台鐵炸彈犯林英昌判30年4月確定	society
狹幅盤整台幣升0.7分	business
獨子父母少陪伴少年戀手遊無法自拔	society
台南客運1個月3司機心臟病發	society
比特幣再攻頂首度站上8100美元	business
獲利亮眼中租明年加薪3%	business
電競敲邊鼓遊戲股大漲	business
首度入圍年終賽迪米特洛夫就摘冠	sports
政院︰軍改版本還有一個月溝通期	politics
台商持槍被泰判罪遣返違「公政公約」台改判無罪	society
屆退軍官轉聘僱軍方明年推國防事務專員制	politics
費城人宣布新主帥上原聽了有感	sports
690億美元CVSHealth買下Aetna	business
小六生1天投209球高中教練︰一定會造成傷害	sports
哈登11月大抓狂火箭西部登頂	sports
毛利率攀升聯發科Q3每股賺3.26元	business
政院：蒐集勞工訴求進一步研究	business
未按時服藥恐造成思覺失調復發	society
軍方攜手交大培養網戰人才	politics
民進黨初選提早到春節前？未來兩週是關鍵	politics
「憲」場直擊》反省後再進化感謝球迷力挺	sports
澳助理教練來頭大「公牛王朝」主力	sports
聯發科推智慧健康晶片1分鐘測出心血管6數據	business
東協設廠甘苦談…用誠意、酒與員工交陪	business
法扶董座范光群出線	society
郭阜林當打擊助教先飛美「複習」	sports
打壓黑幫氣焰警信心倍增	society
HBL女子組預賽》菜鳥王玥媞出頭淡商二連勝	sports
國標舞好手高階警官猝死舞場	society
立院三讀逾18年大貨車換新減稅5萬	business
「永遠都沒準備好」鋒哥勉學弟保持心態	sports
《謠言終結站》下載Line貼圖前確保個資不外洩	business
財經觀測站》落後全球平均的台灣景氣	business
金穎下月掛牌看旺明年市場	business
中國半導體設備市場威脅台韓	business
球員工會將改選胡金龍盼交棒新生代	sports
「家務事」媒體聚焦陽岱鋼先噤聲	sports
苦等大谷點頭太空人有盤算	sports
為社子島案柯文哲破冰拜會葉俊榮	politics
澳門羽球黃金大獎賽》雙李配、白馭珀今拚決賽門票	sports
賊搶民宅起色心六旬婦險遭性侵	society
協會爆灌人頭疑雲體育署：已告發錄案	sports
開賓士包租婆絲巾勒死女兒	society
建仔點名4學員有旅外潛力	sports
「綠能屋頂」費率敲定每度6.4元	business
全台重劃區近千高雄面積最大	business
海峽中線運毒中國1船5人逮回收押	society
桃捷攜手聯邦銀A1站耶誕響叮噹	business
國二女補習遭狼師誘姦	society
建仔最欣賞的投手開幕戰對決哈勒戴奪勝	sports
油價漲2角逼近3年高價	business
冬盟》狂拿16分本屆新高中職4連勝	sports
喬債被開槍追殺朋友接應逃死劫	society
綠能屋頂投資門檻可望降低	business
洪總掌兵符羅德老友串門子	sports
SBL》陳順詳4000分達陣塞勒不賞臉	sports
教授喇舌女博士生被罵下地獄才住手	society
酒後失控伸狼爪強摸朋友妻雙峰	society
冬季聯盟／投野兩小獅驗收秋訓成果	sports
對贏的渴望驚人…日本社會人隊是亞運大麻煩	sports
SBL》璞園戰友成對手累壞兩教頭	sports
歐盟反壟斷調查台積電：初步階段	business
尋獲16歲失蹤少女已成小媽媽	society
幽默且優雅大谷有巨星的fu	sports
心繫台棒困境建仔心中已有藍圖	sports
虎尾糖廠保留全台僅存運甘蔗五分車	society
台男足卡達移訓再添「貴」公子	sports
獵雷艦案軍方今公布首波懲處名單	politics
昇陽勞資達協議注資3合1過兩關	business
看守所遇友興奮比YA詐欺共犯意外曝光	society
《國際現場》中國海航旗下航空恐債務違約	business
黑莓、高通合作打造互聯網汽車平台	business
《財經觀測站》醫生也快失業了？	business
徐生明盃》「曾公」環島行腳義賣球具挺師母	sports
果園種大麻騙舅舅是九層塔	society
女模劉薰愛前男友演仙人跳勒索富商800萬	society
單筆消費上限1000元悠遊卡「數位付」將上線	business
集滿重砲手！洋基盯上馬查多	sports
康控前三季EPS5.56元已超越去年	business
馬指盧麗安投共「沒什麼了不起」	politics
傳動元件全球大缺貨英特爾高層到上銀喬貨源	business
國際現場》蘋果大一統傳整合iPhone、iPad、Mac通用APP	business
土投問路》「美哉」台灣哀哉投手謝長亨：該是修正時候	sports
如興打國際盃陳仕修：要當紡織業鴻海	business
運車回台夾帶89瓶酒秘書幹的老闆無罪	society
《財經觀測站》法人董事與藏鏡人	business
大福彩頭獎摃龜	society
南山變相減薪？金管會緊盯	business
近期股價跌蔡力行︰我只重基本面	business
男女軍官嘿咻雙方配偶求償扯平	society
台股萬點成交量飆證交稅年增逾2成	business
男遭盤查懷恨7年網咖遇警巴頭報仇	society
200員工轉調新廠茂迪︰非裁員	business
股匯雙漲台幣勁揚重現「2」字頭	business
強吻護理師「沈佳宜」社工「趙傳」挨告性騷	society
年年喊拆違建卻創新高	society
一週大事（10月29日至11月4日）	politics
須由總統提名，經立法院同意檢察總長地位不下於法務部長	politics
南韓率先升息台幣淡定小貶	business
冬季聯盟／誘因太強社會人隊轟倒日職軍	sports
雜貨店、珠寶店都是吸金秘密基地	society
王勝偉張正偉週二現身？恐有變數	sports
加蓋違建大火房客嗆昏險死	society
NBA》綠衫軍射下太陽20勝搶先達陣	sports
反勞基法修法勞團高雄抗議	business
限制住居蔡正元千萬交保	politics
府前元旦音樂會濃濃幸福味	politics
15億債權案開庭陳慶男簡良鑑爭辯	politics
「美巡賽的一天」小潘改當老師	sports
大福彩頭獎連45摃	society
勇士「熱好引擎」奪回西部龍頭	sports
金牌小拳王遺體今解剖取出子彈比對	society
殷雄食堂結尾球迷笑著離場	sports
搶小熊輪值曾仁和號碼牌7	sports
川習會今登場我全程緊盯	politics
中國信託女子公開賽》強風中開打侯羽薔並列領先	sports
黨產會：中廣雖賣趙少康資產仍屬國民黨	politics
44歲不礙事一朗拚留大聯盟	sports
四歲男童滿臉血母出面澄清非虐童	society
諸羅山盃》破日7年霸業今拚冠軍留台	sports
廚師逆向超車撞死台大博士生	society
林智勝連兩打席轟蔣砲第5發	sports
蘋果OLED手機和碩明年可望獲單	business
伍茲揮別背痛今自辦比賽復出	sports
講美球員嚴重「斷層」破例收女生	sports
贏了杜蘭特魏少第一次	sports
昇貿擴大投資興建粗錫冶煉廠	business
溜馬終結騎士13連勝後喬治時代猛猛的	sports
星期專論》我們該如何看待李克新「武統台灣」說？	politics
女摔車沒心跳白衣天使路過救命	society
華信能源紅三代掌舵一帶一路先鋒	business
赴中落地簽須檢附台灣身分證	politics
錯過交流道勿倒車停車	society
等了24年陽光法案完成最後拼圖	politics
TOTO日本菁英賽》馮珊珊衛冕LPGA今年唯一連莊	sports
裕隆3人換號他鐵齒不迷信	sports
17萬4596人入股挺體改！	sports
威力彩頭獎連22摃	society
痛斥婦聯會缺乏改革誠意立委籲清查隱匿的資產	politics
連4場敲安梁家榮hold住「打擊王」	sports
菲勞運毒集團走私3kg大麻花	society
RSF主席︰台灣媒體多元可供選擇	politics
地下簽賭獎金高賭徒搏夢總輸到脫褲	society
飯局妹詐富商5100萬願吐還換輕判	society
輕舟變戰艦可成董座洪水樹：明年持續強勁成長	business
勇士少了KD只讓灰狼爽半場	sports
P-3C反潛機今成軍	politics
魔法學校經驗建仔今分享	sports
顧立雄︰拉高外資稅負恐爆匯出潮	business
派出所勤教播錯片員警插播求婚啦	society
兩個名女人的戰爭意外成焦點	society
中和大火／肝硬化沒帶走他保全被火神帶走	society
無罪可聲請冤賠最高可獲14萬5千元	society
欠尊重！馬林魚大清倉惹惱球員	sports
姚立明妻楊芳玲被提名監委引發議論	politics
職桌年終賽莊智淵連18年獲門票	sports
HBL／陳孝榕好膽挑7號扛南湖頭牌	sports
「機車」美眉酒駕拒檢逆向、闖紅燈甩尾犁田	society
黑豹旗》徐世凱再見安興大附農晉4	sports
雄獅聯手保保搶攻日客商機	business
關懷盃》大聯盟專用球王維中隨身攜帶	sports
撞死人要賠1億？客運司機上吊	society
成功嶺闖哨役政署長辭職	politics
夢幻緣份周董還收著陳文杰的信	sports
下月瓦斯每公斤漲6角近3年新高	business
消息錯亂穩懋遭錯殺、波若威漲停	business
移工悲歌／苦命鴛鴦見面前夕夫成焦屍	society
《吸食器也塞》D奶好激凸～原來藏毒	society
工商界︰防投資台灣排擠效應	business
舉重「藥」不得奧運考慮剔除	sports
台糖養豬場沼氣發電自用	business
美國拒承認中國市場經濟地位	business
Lululemon電商零售雙贏儒鴻受惠	business
洋將比「大尺碼」搶當扛霸子	sports
冬季聯盟／王威晨驚天一擊中職拚出態度	sports
三中案檢搜索中投、衡平公司	politics
澳門羽球黃金大獎賽》抗中後來居上白馭珀首闖女單決賽	sports
張鐵志翻版2學者赴港交流也遭拒入境	politics
8賊問路、裝跌倒、洩輪胎氣…珠寶商早被盯上	society
半導體設備投資三星今年砸7830億	business
都敲10安台灣1分羅德6分	sports
特勤中心副指揮官林文豪周廣齊呼聲高	politics
在車上對女子自慰搖下車窗被判有罪	society
日巡封關戰盧曉晴賽史最低桿封后	sports
豪小子報告傷情：可正常行走	sports
行動支付普及率2025年要達9成	business
慶富詐貸案簡良鑑300萬交保	politics
中信盃三冠王盼與殷仔「投打對決」	sports
聯家軍作帳行情啟動智原、原相是主角	business
APEC》數位經濟論壇詹宏志將任主席	politics
GPS查案要立法辦案不用怕違法啦	society
少棒投球數擬設限教練有歧見	sports
國家利益當籌碼擋總預算缺正當性	politics
韓教頭真心話：王柏融應該打冬盟	sports
冬盟》打到一半召回日本社會人上班去	sports
樂陞拆售產品線辣椒有意拿授權	business
李明哲被判刑陸委會：滾動檢討兩岸政策	politics
台積結合封測接單將擴至AI	business
活塞2奇兵逼退綠衫軍	sports
台日青棒賽》范柏絜牽制「自滅」高苑2連敗	sports
國民參審制內容摘要	society
2017豐收全球股市「漲」聲鼓勵	business
賴揆視察警調宣示「掃毒為國為民」	society
NIKE青棒訓練營》投球小細節建仔親自「腳」正	sports
施以冗長審查博通併高通中國恐設路障	business
透天厝只要半價?假賣屋詐185萬	society
「共生連線」重現吳念庭︰從沒想過	sports
子公司恩德獲利轉強事欣科進補	business
台日男籃同落難明年再對尬	sports
岱桑第一手消息巨人也愛王柏融	sports
柯︰核准陳抗路線要檢討	business
摩鐵櫃檯說溜嘴醋男闖進房揍死小三	society
48被告允賠償逾半沒履行	society
無間道真實版╱小隊長出賣隊長洩個資給黑道老大	society
護照出包被拔官龔中誠反批：部長核定的	politics
HBL》南山松山火力猛攜手晉12	sports
車寬如轎車操作不熟易出「撞」況	society
違約停權慶富最久禁投標三年	politics
朱銘的伯樂是色狼電梯內5度襲女腰臀	society
孕妻載女墜谷深情夫沿路急尋救3命	society
海空搜救幻象發現疑似求生訊號	politics
沒「雙勝」的中信兄弟旗艦店開幕	sports
杭州地價翻倍新纖有意賣地遷廠	business
半導體業︰不因外資報告動搖策略	business
殺學妹「非臨時起意」男大生收押	society
美稅改有利出口商疑違反WTO規定	business
北市長人選國民黨將全民調	politics
iPhone明年新機將見6.5吋螢幕	business
紅雀搶史砲情願人財兩失	sports
「按這個」難證明做半套負責人不起訴	society
李登輝舉手挺柯P	politics
「我沒放水」林智勝以淚明志只想好好打球	sports
書劍集》比特幣驚魂	business
百萬象迷急凍不及格的9404人	sports
二刀流指南腦筋急轉彎／6天先發1次、期間3天DH	sports
財經觀測站》道德勸說有用嗎？	business
帶青棒太燒腦王光輝嘆「不簡單」	sports
NBA》保羅歸隊點「火」哈登砍48分射日	sports
賊偷漢朝玉琮銷贓不成先落網	society
每人16.6萬基本生活費免稅明年適用	business
妻小都在車上醉爸「倒退嚕」逃酒測	society
慶云骨灰罈吸金79億二審逆轉有罪全沒收	society
建仔真心話這一年空白很茫然	sports
促轉條例三讀》黨產歸公用於長照、社福等事務	politics
厄文不在綠衫軍遭爐主擊沉	sports
《財經觀測站》末升段必有妖孽	business
冬盟》例賽8連勝、9連不敗中職寫完美結局	sports
證券行情表、證券表格	business
美科技股重挫拖累亞股下跌	business
三分球「27投3中」！勇士中止11連勝	sports
大聯盟群魔亂舞天使二刀流能走多遠?	sports
中國逼外企設共黨組織德企怒嗆撤資	business
證券行情表、證券表格	business
推動區域資安聯防政院規劃六都領軍	politics
單親爸不贊助買機車少年賭氣上吊亡	society
又見兒虐...小兄妹大面積燙傷	society
前進印度矽谷台達電、億光秀實力	business
PO文指餐廳有蟑螂老鼠男加重誹謗起訴	society
《謠言終結站》ATM明細表不會洩個資	politics
洗地疑誤觸延長線收容人遭電死	society
教訓10月嬰玩飲水器虎爸拉兒手碰熱水	society
小三拿「雙人枕頭」進房偷吃鐵證全都錄	society
混毒雜質多複合檢驗包易誤判	society
土城鵝肉名店遭縱火1死4傷	society
飛車撞進郭董愛店2男爬出落跑	society
政策環評奠基離岸風電半年通過19案	business
奧會改選羅生門》體育署：提書面資料證明	sports
杜拜年終賽》決勝局最多輸6分戴資穎驚險首勝	sports
遙指東京奧運女壘亞錦賽昨台中開打	sports
惡男餓死中風母、兄檢求處極刑	society
鹿窟事件受害人盼建紀念館	politics
中和大火／社會邊緣人3度縱火燒死好友	society
雨遮屋簷不登記北台建商當讓價優惠	business
救國團靠「幽靈辦法」大做旅館生意	politics
「我是三軍統帥，我一定會照顧大家」蔡上莒光園地：軍人退撫從優	politics
《國際現場》那斯達克傳明年推比特幣期貨	business
中國放寬外資持股銀行上限	business
國民黨中央黨部大樓市價40億只賣23億	politics
學怎麼投／羅嘉仁3天體驗有效就赴佛州	sports
離譜孕婦肝病住院溜走乾掉整瓶高粱倒地	society
歐盟山寨黑名單中國名列首惡	business
美稅改稅率反增科技大咖錢續藏海外	business
慶富案最大損失15億土銀：不影響繳庫和年終	business
《醫師建議》遇暴力男友先求援自保	society
社會人冬盟2敗都輸給中職	sports
台日青棒賽／迫日戰術成功平鎮噴火2連霸	sports
60次大三元大帝超越大鳥	sports
內鬼情報員高院加重改判	politics
相戀4年／小情侶摔車16歲女遭後車撞死	society
中職》林威助續披黃衫轉任二軍教練	sports
都更修法擬撤釘子戶防火牆	business
「自閉」林哲霆飆分秀功虧一簣	sports
中選會人事審查惹議資料不齊下週再審	politics
海康威視中國安控龍頭	business
汽油漲5角95無鉛達27.3元	business
通緝犯拒捕奪警槍對空鳴槍逃亡被逮	society
「主任當家」若不改救國團活動中心將禁營業	politics
一週大事（11月26日至12月2日）	politics
醫療外交轉型國合會推公衛專案計畫	politics
中華郵政︰先代償將向陳員追討	society
高雄市副市長許立明為高銀抱屈：好像怎麼做都不對	politics
連跌6日比特幣昨大跌21%	business
開發3D感測晶片華晶科與美廠結盟	business
美國會促邀台參加軍演軍艦互訪	politics
尼克新一哥波辛傑斯飆40分逆轉秀	sports
5度誘上床出事閃人搞大少女肚子鐵焊工判賠25萬	society
摘下眼鏡林文伯老來俏	business
總預算案遲未過恐影響軍公教加薪	politics
2500萬大牛失控撞3車衝騎樓3傷	society
有話「職」說／誰不想留在台灣踢球	sports
警抓到褲管撐不住毒販高市刑大跳樓亡	society
SBL》南部三劍客護航台銀破咒獨走	sports
活塞防守升級差龍頭半場勝差	sports
燒炭取暖引燃棉被燒死節儉老夫妻	society
又是司機打盹公車撞斷號誌桿	society
卡盜陰！夢到七爺八爺拉他醒來警在身邊	society
資深球友︰機率跟雷擊、1桿進洞一樣低	society
《國際現場》日媒︰蘋果明年續推OLED機種	business
公建挺內需賴揆︰明年GDP拚上修	business
19歲情侶當車手家長恐遭求償百萬	society
開發商多肯定商總籲說到做到	business
性騷中山女高8學生狼師終身不得任教	society
富邦長春公開賽》謝敏男同齡同桿奪唯一紅字	sports
狠殺女友扔裸屍裸男跟著跳樓慘死車頂	society
裁撤六外館資源挹注新南向	politics
223隊參賽諸羅山盃創新高	sports
打敗世界第2黃鈺仁惜摘銅	sports
大帝大三元捧球哥為跳槽？	sports
少年開槍子彈轉彎衰翁車胎消氣卡彈	society
拿關渡國小練槍20歲男帶槍投案	society
民進黨第7代發言人最年輕僅28歲	politics
比特幣加持╱利機明年獲利成長上看5成	business
韓左砲多陳冠宇戰前特訓	sports
獵雷艦案》國庫署列席紀錄立委：簡太郎喬聯貸	politics
４煞砸天燈店潑漆店主男嬰滿頭紅漆	society
裕日車創新風雲賞鼓勵學子巧思	business
洽商國共論壇？》駁曾永權赴中申請府：誠實是基本原則	politics
徐生明盃／變化球禁入龜山另類復仇	sports
雙親皆打火英雄戴資穎代言防災大使	society
才分開5天…父悲鳴：我的孩子呀～	society
連任路險阻蔡修補與獨派關係	politics
C羅、梅西平分近10年金球獎	sports
申皓瑋奪MVP笑稱等很久了	sports
《財經觀測站》郭董的空污視角	business
母抱女嬰玩蛇板6歲哥推母跌嬰撞死	society
亞冠賽》扭轉台灣味「陳陳大丈夫」	sports
「相信直覺」發現遭跟蹤儘速報警	society
黑紙換美金詐千萬追出黑人集團	society
黃國昌：李瑞倉幫慶富喬5.5億貸款	politics
前新北市副市長許志堅涉貪二審仍判10年	politics
小老弟太衝岱桑點破盲點	sports
更生人畫家吃醋開槍毀了新生	society
美太陽能庫存仍高台廠明年恐續虧損	business
台彩威力盃》8強沒地主桃園挺進連霸路	sports
卡森斯老弟助拳寶島夢想家	sports
韓職1洋投年薪6000萬夠付桃猿2∕3本土球員	sports
登山自治條例4縣市自訂	society
《焦點評論》馬的主觀犯意	politics
《醫師建議》預防憾事1問2應3轉介	society
雷霆CPR連線贏家卻是鵜鶘	sports
電競夯微星、技嘉分頭搶攻	business
中科院衍生公司非鐽震模式翻版	politics
擋促轉告洋狀民進黨批國民黨邏輯錯亂	politics
焦點評論》黨內拔擢要制度化	politics
國中生偷香油錢父兄交廟方踹胸教訓	society
賭技太強賭神豪宅被轟成蜂窩	society
嬤載兒孫問開店吉時國道遭撞1車4死	society
2017台灣企業永續獎中信金獲5項殊榮	business
冬盟》赴日曾練二刀流陳子鴻棄投選打	sports
郭台銘：互聯網可助製造業轉型升級	business
大樂透頭獎連12摃	society
爵士中特獎菜鳥米契爾寫驚奇	sports
教頭曾是盜壘王汐止小胖會怕	sports
安謀進軍伺服器物聯網成契機	business
中油加油站將轉型「綠能站」	business
PChome拚雙11每4秒賣1支手機	business
光芒擬重建胡智為趁勢竄出？	sports
五輕整廠輸出印尼印度搶親	business
SBL》「小巨人」挺主題週讚「氣氛很好」	sports
11月出口年增可望衝2位數	business
東京巨蛋當觀眾「四爺」初體驗	sports
「薪」亮點》陳禹勳挑戰桃猿投手「薪一哥」	sports
報案變備案警被控吃案	society
歐盟批中國干預嚴重扭曲市場	business
CES大展台廠將組隊赴會	business
降稅拉抬成交量11月當沖戶創新高	business
被控洩馬習會機密馬不起訴	politics
黑豹旗／輸一場就OUT平鎮連霸更顯珍貴	sports
中化銀髮攜手30個夥伴建平台搶居家照護商機	business
神腦總裁砸5億買信義區豪宅	business
雨遮不登記下月上路建商︰不易漲價	business
媒體正妹團路跑「嬌點」	sports
綠能屋頂拍板住戶零出資可打平電費	business
柯瑞繃帶纏身加班變身電湖人	sports
牛棚飆速2火球男0防禦率	sports
勇士少2王牌「KK連線」也能贏	sports
司進會改革首彈公益律師天團成軍	society
證券行情表、證券表格	business
租賃專法未納居住安全立委抨政府裝睡	society
跨足新藥、醫美寶齡下月掛牌	business
台澳FTA澳洲議員：中國打壓停擺	politics
連撞4機車1人傷計程車運將落跑	society
富邦777拍出每坪失守百萬大關	business
亞冠賽震撼之旅洪總「看見潛力」	sports
太陽能廠三合一提產創金援過頭關	business
國中生偷香油錢父兄交廟方踹胸教訓	society
積欠百萬債務男當街遭痛毆擄走	society
菊池加薪1億日圓西武前所未見	sports
中和大火／10年前被檢舉違建...沒事	society
中油新南向五輕落腳印尼	business
一週大事（11月5日至11日）	politics
中職後勤好貼心洪總︰比以前棒協好	sports
7顆三分球破咒柯瑞擊沉快艇	sports
大專籃賽明開打選手想「攻蛋」	sports
MLB》想再拚1冠洋基簽回沙胖	sports
警：鵝肉店少東若違法一併究辦	society
扯！4部會核定2.2億補助69家問題社團	politics
政治受難者籲：不義遺址仁愛莊軍方應釋出	politics
中職》週刊爆婚外情林泓育喊告	sports
30歲女邀13歲少男同居判刑1年	society
回鍋董座鄭文隆拚台船翻身	business
女童母知情不吭聲︰剪都剪了我能怎麼辦	society
交代老公買威力彩中12億「全家翻身」	society
染「紫」台灣封測廠中國改攻子公司	business
欠債自救／求助公所銀行公會或警方	society
玻璃牆大有來頭王維中搶贏動力火車	sports
富商豪宅挨51槍槍手曝光連換3台小黃	society
靠賭起家早年疑藉轉播秒差海削	society
HomePod延後上市力麗：拉貨力道未減	business
賤賣黨產案前北檢主任︰馬涉背信起訴機率高	politics
組織犯罪新條例下月生效	society
全球百大科技研發獎工研院奪九項	business
追撞摔車小情侶酒駕累犯停車後落跑	society
HBL》驚險氣走「小綠綠」普門連3季晉8強	sports
《威力彩》頭獎摃龜	society
因應日韓怪投台灣拚奧運有所「側」重	sports
藍營炒作高雄幫陳菊籲勿轉移焦點	politics
心繫台棒困境建仔心中已有藍圖	sports
洛城騷動天使場均可望破4萬人	sports
全中錦》3破大會張秝羚只想超越張秝羚	sports
吳敦義怨賴揆沒聽意見宣布不見蔡英文	politics
稅改過關川普可能明年初簽署	business
世界盃亞洲區資格賽》戰澳當天生日劉錚拒絕難堪	sports
王柏融節奏亂掉洪總：罕見	sports
衝火場救出孫女嬤重傷來不及救孫	society
《國際現場》日降公司稅鼓勵企業加薪	business
一帶一路受挫200億美元工程沒了	business
獨董難為「跳船」逐年攀升	business
學者挺張忠謀：加薪可呼籲不能干預	business
馬︰兩岸跨國詐騙犯應送中國審判	politics
亞冠賽》扛4番未建功陳子豪自責	sports
嚴宏鈞好會挑「蕉」來好運到	sports
日本LPGA大王製紙女子高球賽》南韓全美貞獨走盧曉晴拚衛冕	sports
洋基總管渴求大谷：願保二刀流	sports
金門海邊驚見死豬不排除來自中國	politics
從雙通案看半導體國家隊	business
少年打2份工攤家計騎機車趕上班撞死神	society
柯文哲：我和民進黨高層關係很好段宜康：民進黨不看高層只顧基層	politics
偷民進黨部9萬韓籍慣竊判5月	politics
億光獲印度路燈標案估至少進帳7、8億	business
剁情敵蛋蛋當鱉虐殺男患酒精障礙症改輕判	society
新一代高教機擬支援對地攻擊	politics
獵雷艦案立委促檢速傳簡太郎	politics
稅改不宜再拖	business
下週油價看漲5角29個月新高	business
陳冠宇追殷汲取美日精華	sports
不做S被硬上金錢豹酒女堅提告拒大哥30萬封口費	society
大學生想吃薑母鴨夜闖墓園旁偷1隻	society
國道出「撞」況保命要訣先按警示燈	society
悍女只為8萬元活活打死同居女友	society
為大谷佈局天使喬6人先發輪值	sports
UBA》國體大加班逆轉潘向挺8強再助拳	sports
移民署核心設備禁購中國製	politics
民進黨新決議文明年中出爐	politics
一週證券行情表、一週櫃檯行情表	business
醫師︰單點疤痕沖水塗藥冰敷會復原	society
Q4利率料維持不變央行明年有機會升息	business
吳政祐加入泰山前籃球資歷0	sports
鄧愷威簽約金比胡智為高球探有解	sports
世界盃亞洲區資格賽》台版艾佛森蔣淯安扛主控	sports
挑戰布拉障礙逾2公尺外援夯	sports
資安即國安蔡：建國家級資安團隊	politics
豐田逾十款電動車2020～2025年上市	business
運動協會調查》泳足羽網棒籃滿意度不佳	sports
涉勒贖出賣朋友男畏罪自轟亡	society
阿貢火山亂賽程台灣男足連踢3天	sports
大福彩頭獎摃龜	society
川島慶三再見安軟銀奪回「日本一」	sports
無照騎三輪重機自撞妻女拋飛亡	society
結婚50年／病夫殺72歲老妻砍30刀鎚爆頭	society
副駕喊不要停害死女童二審依殺童共犯重判	society
新談判倒數美要中交承諾細節	politics
女鬧婚宴自稱黨工時力︰她非黨員	society
《財經觀測站》把股市春藥當補藥	business
重機騎士卡車底熱心人抬車救援	society
立院三讀非職業外交官上限調至15％	politics
報復中國美貿易政策趨嚴	business
理光盃女子日巡賽》好手感延續盧曉晴單獨領先	sports
奧客訂56杯飲料不取還嗆敢報警就砸店	society
被害人可參與訴訟／可避免對死者家屬二次傷害	society
撒錢大叔1年舉報2千案	society
挑戰布拉障礙逾2公尺外援夯	sports
澳盛︰專注提供高科技業金融服務	business
國防部：18趴分10年調降緩和衝擊	politics
ABL》寶島夢想家主場開幕戰5200球迷相挺	sports
大巨蛋弊案4被告聲請解除境管	business
本週油價調漲1角	business
重機飆進國道怪導航凸槌	society
先輸19分倒贏20分勇士拔刺	sports
負責維修戰術輪車兩士官長竊軍料給業者	society
林泓育偷吃疑雲爆對象為女大生	sports
總仔忍住不喊卡南山女將成功進化	sports
醉漢拍車窗遭女駕駛友人圍毆	society
黑色正確！騎士奪7連勝	sports
劉泰英：一例一休這樣吵法對勞工不利	business
國民法官的資格	society
萬事達卡、中華電合作HamiWallet升級	business
為了女友愛上烘焙…就這樣被醉駕奪走命	society
戴鋼鐵人面具搶超商父掩飾他出國	society
博通3.9兆提親高通料將拒絕	business
建置新南向金服平台天逸明年擬併購上市	business
綠屋頂整合門檻可望降至50戶	business
短報1.5億空污費聚紡負責人詐欺罪起訴	business
人民幣存款餘額創27月新高	business
交警搭小黃追逮落跑酒駕男驚呆	society
辜成允跌死晶華總座、名建築師有責	society
反特攻操演黑鷹、海鷗降國防部	politics
職棒轉業餘林志祥月薪少近30萬	sports
為專利費用撕破臉蘋果新機擬拒高通晶片	business
漁工鬥毆印尼打趴菲律賓1死5傷	society
慶富找到金主?海軍態度轉趨曖昧	politics
強制車險酒駕加費明年3月3600元起跳	business
狗狗暴衝拉倒鐵柵門壓死女主人	society
曾被威脅？史砲轟老東家「像馬戲團」	sports
申皓瑋敲首轟中職聯隊遭逆轉惜敗	sports
證券行情表、證券表格	business
主管酒駕撞分隔島亡3越勞共乘受傷	society
民進黨籲團結勞基修法下週出委員會	business
接見美國訪團蔡英文︰增列預算強化國防	politics
大樂透頭獎摃龜	society
激勵加薪員工薪資列報上限調高	business
世界大賽》太空人脫魯了遊騎兵改當爐主	sports
慶富找到金主?王定宇：放煙幕彈	politics
米店夫妻為錢尋短夫自焚傷重不治	society
汽車隔熱紙大廠曾因勞檢不合格罰5萬	society
電競NB出貨急拉藍天旺到明年農曆年	business
毒海沉淪10年的代價…女兒出生日落網淚崩	society
梁國源︰3錯誤假設經濟溫水煮青蛙	business
無良藥頭A利潤毒品摻肥料	society
刑法將修╱殺人致死無限追訴彭婉如劉邦友案可望解套	society
吳永盛獲沙大單週最佳運動員	sports
yes123調查︰79.3％企業計畫加薪	business
核四維護費立院刪1億通過	business
兩件球衣拍賣178萬這就是萌神	sports
一層樓隔15間出租公寓大火1死	society
球員都愛他！艾圖維2大獎連霸	sports
數幣機點10萬需先分類2小時	society
世界青少年桌球賽》林昀儒臂傷男團無緣4強	sports
三星7奈米難產台積大吃高通訂單	business
公車散熱蓋成血滴子砸昏騎士	society
稅改拚年底過關有兩大罩門	business
嫩男說想變性醫師建議仔細評估	society
第1場最難打簡浩展現老將價值	sports
澳聯5台將齊上林智勝開轟最猛	sports
星期專訪》「不論五缺或一例一休賴揆展現企圖心和執行力」許勝雄:可以捲袖子拚經濟了	business
台中豪宅宝格億豐粘家2.17億買2戶	business
南英OB賽》新人王好「薪」情詹子賢挑戰翻倍	sports
一下進一下退…路上「跳探戈」運將醉撞17車	society
從小立志從警任職7天車禍亡	society
賴文祥前進緬甸笑稱青暝不怕槍	business
英10年首次升息美利率維持不變	business
花10億研發AR、VR廣達Q3毛利下滑	business
堆高機貨叉戳破木條2億元K毒意外露餡	society
幻象失聯逾一週縮小範圍定位	politics
國民黨首波徵召月底前出爐	politics
世界盃亞洲區資格賽》期盼為國爭光陳盈駿卻逢生涯最重傷	sports
太陽能費率降幅縮小業者：再低就沒人做了	business
擴產iPhoneSE緯創傳在印度覓地設新廠	business
內幕追蹤》出錯圖樣龔中誠任內定稿	politics
「球哥」最嫰大三元超越詹皇	sports
威力猶如迫擊砲要價逾百萬	society
外資狂倒131億元法人:台股趨勢未反轉	business
警包庇賭場案延燒19人漏夜偵訊	society
新南向工作小組鄧振中任召集人	politics
《國際現場》北海油管破裂原油升破65美元	business
強吻網友手伸裙底男大生賠42萬	society
中和大火／縱火犯「無法」強制治療…易成治安未爆彈	society
田本玉「過度換氣」子弟兵逆轉勝補償	sports
男入香閨沒達本壘被告挨酸「只剩1張嘴」	society
林美珠︰透過機制把關避免過勞	business
台銀拚主題週祭大獎衝票房	sports
租不起金店面往上租銀樓面	business
揭發秦偉獸行第一人濱小步訂婚戒宅配不翼而飛	society
美學者︰中難改惡習科技冷戰難避免	politics
林政賢今先發力破5局關卡	sports
瘖啞台灣英雄又偷又搶法官不給減刑	society
國際油價強彈下週油價估漲3到4角	business
全家砸百億搶攻電商市場	business
黑幫介入政黨警署不再沒轍	society
高思博想選南市長高育仁：不贊成	politics
智慧棒球內藏投手玄機	sports
拐友人女兒嘿咻蛋蛋大小粒成鐵證	society
收賄罪認定法界籲修法解決	politics
稅改拚年底過關有兩大罩門	business
開臉書直播試槍網友報警就栽了	society
分析師：比特幣泡沫破裂對金融市場影響不大	business
賴母麵攤搬離傷心地淚水止不住思念	society
150kg司機激瘦80kg換身分證戶政員不信	society
台灣技術領先世界施振榮勉當AI先行者	business
誰開我的車？酒駕撞死女騎士裝傻	society
瑞莎為拿我國籍烏克蘭使館屢刁難	politics
台股短線盤整汰弱留強盼明年	business
愛不到俏老闆娘狠員工割喉奪命	society
報復女友離家水電工攜2幼女燒炭3亡	society
搶救獵雷艦案銀行團求助金管會	politics
「憲」場直擊》打亞冠賽比「台日賽」更緊張更想贏	sports
賴揆：內閣隨時檢討沒固定時間	politics
「台灣隊加油區」門票快搶光	sports
諸羅山盃》領社區隊躋身8強李致霖可望飆進名校	sports
國際現場》iPhoneX14國感恩節上架	business
央行今理監事會議估利率連六凍	business
理事長直選「大鬥法」林德福：再溝通	sports
酒駕撞傷高中老師消防員逃回隊部	society
擺脫證所稅陰霾台股量近8年新高	business
從承租到經營中信可望洲際作主	sports
證券行情表、證券表格	business
YY棒球訓練營》拚明年上大聯盟張育成加練三壘	sports
政院籌組促轉會動用第二預備金	politics
母攜2子女燒炭》如果再早一點發現就好幼園老師仍自責	society
台灣巴拉圭經濟合作協定三讀	politics
造船、造艦、離岸風電台船營收將三分天下	business
國機國造更近了漢翔與48供應商簽約	business
水利會改制公務機關今拚付委	politics
彰化縣長選戰》搞黑道大整合？藍綠隔空交火	politics
世足賽》半世紀來無人連霸德國拚了	sports
威力彩頭獎連28摃	society
李明哲判刑美國務院促中國放人	politics
練靶射爛女騎士臉空氣槍玩家收押	society
有財力投標者恐剩壽險大咖	business
小檔案》封測技術CoWoS與InFO	business
APEC》支持女權台美澳成立婦女基金	politics
松菸富邦槍擊案槍手雲林落網	society
FA權利在手黃浩然考慮中	sports
威力彩頭獎連24摃	society
太陽能業者轟政府變屋頂仲介者	business
大樂透頭獎連13摃	society
朝野都買帳賴揆首戰輕騎過關	politics
惡煞劫超商綁人店員「殭屍跳」求救	society
綠委建議政院對修法道歉	business
公平會扯後腿1家樂眾家愁	business
保險黃牛集團教裝殘詐2400萬	society
昔為皇家齊拚冠今攜手「東山再起」	sports
台達電工業自動化收成電動車起飛	business
民進黨︰若無共識促轉條例直接表決	politics
巡官與小警平日認真無負評	society
點擊人物》168公分無極限艾圖維拚雙料MVP	sports
SBL明開打機票、手機「禮讚」球迷	sports
「想看松坂投球！」號召力更勝曼尼	sports
臉骨折歸隊他領公牛衝業績	sports
聯結車閃避黑豬豬遭輾死車自撞	society
SBL》百分百陳堅恩送達欣第一敗	sports
車禍地點都一樣大數據揪詐保	society
鐵皮停車場大火吞噬11車	society
中國信託發行LEXUS聯名卡星展銀椎心	business
台灣大賽》最鮮肉的一轟小阿飛8打點驚奇	sports
小摩看壞鴻海目標價降至90元	business
役政署長闖軍營挨批座車司機調職	politics
欣裕台提停止凍結資產訴訟	politics
今彩539頭獎13注中獎金大縮水	society
生活市集結盟團購網愛合購	business
追訴期剩4個月逃亡23年沒回過家性侵通緝犯落網	society
黨產會對婦聯會下通牒26日前協商未果就開鍘	politics
立委提案》加班可加成換補休工商界︰勞工難受惠	business
分手的策略故意暴露缺點也是一招	society
運動員第二春系列報導／永遠棒球人揮棒賣餃子	sports
衛星導航變迷航女開車卡山溝	society
亞冠賽》羅德教練盛讚陳冠宇歸功情蒐	sports
7隊憑什麼？進入大谷射程	sports
鮮活果汁前3季EPS9.26元	business
越配報案警嗆滾回自己國家	society
政府代拆立委、民團︰應排除自劃都更	business
家屬放棄急救鼎玉鉉老闆娘拔管	society
教頭：落敗不是結束，是開始	sports
SBL》韋總「信任籃球」郭少傑扮板凳暴徒	sports
「台灣噴射機」改裝連豪哥都叫好	sports
職棒首蹲捕陳重羽夠「穩」重	sports
《阿政》威士忌值10萬追劇鴛鴦盜摸走	society
李明哲判刑》李凈瑜：即使一天都是非常重的刑責	politics
戲院小開家遭竊電眼揪賊	society
資源回收站驚見日製軍用子彈	society
民進黨高雄市長初選參與者多盼提前	politics
中國毛巾傾銷落日調查損害我產業	business
新南向國家首達陣台菲更新投保協定	business
茂林銅鑼廠明年產線增一倍訂單入手	business
南英OB賽》郭泓志返美復健人沒到禮數周到	sports
產學合作光寶培育本土人才	business
擊斃賊警出庭︰護民的槍當然要用	society
企聯女壘頒獎杜雅婷奪5獎	sports
哈登致命2犯綠衫軍逆轉	sports
總預算案審查時程延後》國民黨反怪民進黨排爭議法案	politics
徐生明盃》兩外籍裁判自費來台「做功德」	sports
「怪物」兩樣情》史坦頓自學成才靠怪力和毅力	sports
彰顯國防自主蔡年終記者會將移師中科院	politics
共享運具正夯單車、汽機車搶市	business
體總狀況外要「關閉」無權管理的協會入會網頁	sports
揪團去爬嘉明湖廂型車逆向撞貨車8傷	society
防彈總統座車運抵月底交車	politics
色魔誆「補陽驅鬼」性侵4女73次	society
重機男墜山谷身亡同伴路過渾然不知	society
印尼女看護想脫逃豪宅墜樓亡	society
鄭達鴻難過被釋出！相信自己還能打	sports
挑戰英特爾高通伺服器晶片供貨	business
新南向最大投資石化園區擬落腳印度	business
冬盟》「娶某前」林立連2天敲超前分	sports
大福彩頭獎摃龜	society
外役監逃犯與妻雙載警狂追7公里	society
罵綠蛆噁心寄生女拗沒侮辱意圖	society
年終賽》扳倒印度一哥周天成開胡	sports
國民黨拒繳8.6億智庫建物被查封	politics
po文跨年嗆放詐彈兩男被逮	society
矽晶圓缺貨崇越、環球晶笑哈哈	business
冬盟》高井俊「龍捲風」投法不當野茂做自己	sports
警察也是人須互相體諒	society
亞獅康擬增資藥品授權好事近	business
第一代兄弟王朝葛雷諾永生難忘	sports
如何防範孩童玩火釀災	society
豪哥開口要合照…鐵粉請他等等	sports
總統將頒回復名譽證書給政治受難者	politics
自爆上山採牛樟菇沒得手照樣罰	society
本週熱點》軍人年改月退地板敲定32160元	business
幻象失聯2週監委申請自動調查	politics
明年全球股市新興市場、歐股最好	business
國民黨北市長人選要看柯綠競合結果	politics
NBA》最後1.5分鐘挺身捉熊大帝率騎士11連勝	sports
張小月︰一國兩制在台沒市場	politics
中國火鍋市場「燙口」王品西進二度收攤	business
光寶蘇州光建紫光入股55%	business
戴資穎一年7大冠空前紀錄	sports
慶富案4路線查弊已有9被告	politics
港客同班機同班車拿錯行李千里「箱」會	society
獨厚救國團天祥活動中心每坪月租6.7元	politics
無線充電正夯德微、虹揚、維熹成法人標的	business
電影門徒真實版／為拯救女友痴男陪吸毒墜深淵	society
婦聯會簽備忘錄343億捐國庫	politics
SBL季前系列報導》缺少得分箭頭台啤攻堅隱憂	sports
離岸風電公聽會籲檢討躉購費率	business
欣銓股價創11年半新高	business
高盛看好比特幣微星、技嘉歡呼	business
火箭末節變陣砍40分大逆轉	sports
各國職棒「怪」俠也能投出名堂	sports
櫃買中心明年3月新增電子商務類	business
三寶貸款收回顧︰與永豐金涉弊兩回事	business
拍童猥褻照、淫片加重判刑罰金	society
人過世先通知銀行可避免被盜領	society
布恩接掌洋基「我準備了44年」	sports
Uber司機生意差下海當馬伕	society
大樂透頭獎連14摃	society
分3組作案→把風→逃跑如電影情節	society
女壘亞錦賽》我全勝晉級今戰菲律賓	sports
怕傷高官仕途南市警分局暗槓槍擊案	society
自駕車實驗場址5都已選定	business
帶動營收電信業盼廢除網路中立	business
晶圓廠老闆親自出馬固貨源	business
謠言終結站》「國安法」辦共諜？補足內亂外患罪無法適用	politics
佈局智慧工廠封測朝無人化邁進	business
《威力彩》頭獎連23摃	society
壯女26刀砍紙片男皮帶綁腳拖上床	society
最壞身教！母要7歲兒當扒手	society
建仔探望病童分享受傷歷程	sports
李登輝：啟動憲改阻擋中國法統政權復辟	politics
扛起七六人恩比德逼延長止敗	sports
綠衫軍接二連「傷」厄文復出頂得住	sports
兩岸合編國文教材台灣多校採用》國教院：出版社自行贈送推薦	politics
世界盃資格賽》同穿27號黃鎮師法野獸	sports
高市長初選辯論民進黨5立委交鋒	politics
安親班狼師狎女童寫作業午睡也不放過	society
新北市長選戰》洪耀福稱侯友宜曾說不選侯：沒印象	politics
新聞分析》林佳龍迎戰政績當後盾	politics
台北馬拉松》舊紀錄保持人應援謝千鶴半馬破全國	sports
運動員第二春》張家源突破心魔開業當調理師	sports
公車司機昏厥撞騎樓火燒車	society
關懷盃》莊陳仲敖完投無失分玉里高中青棒稱霸	sports
台灣隊「側」重》陽氏嫡傳朱誥鎮改「投」換面	sports
運動家祈「旺」對手變「乖乖」	sports
英示警：比特幣買家要有全賠光準備	business
王道銀行通過B型企業認證	business
趕送友人最後一程失控撞死翁	society
男大生酒駕肇逃樂團主唱重傷女友亡	society
黑豹旗》王彥程雙殺解危穀保2度爭冠	sports
中職最會轟的兩男人旅澳同場紅不讓	sports
淘汰好麻吉東泰主帥痛且快樂	sports
少女開淫窟還推親妹妹入火坑	society
王忠義弒親案中高檢列64頁理由上訴	society
亞、奧運正式項目首例》理事長直選角力協會響應	sports
中國供應商︰未收到蘋果砍單通知	business
球哥鬧紐約波神加班看住門	sports
沃爾秀準頭巫師3連勝	sports
兩場26K的教訓洪總︰失敗也是好事	sports
不接第一金許璋瑤掌證交所	business
冬盟》大聯盟級莫蒂森：亞洲基本功紮實	sports
無緣世界盃義大利60年第一遭	sports
提昇台灣足球陳柏良以身作則	sports
注資太陽能合併案？國發會︰未定案	business
冬季聯盟／韓職火力連貫歐美隊難招架	sports
1分險勝雷霆、綠衫軍幸運日	sports
職場遇不當追求慢慢疏離是上策	society
慶富聯貸案傳喚一銀前董座蔡慶年	politics
獵雷艦後續預算立委喊刪	politics
汽油漲六角油價創近三年新高	business
行動支付拚2025年達九成	business
台塑汽柴油週一起漲1角	business
中國擴大間諜認定陸委會籲尊重人權	politics
周天成「大欺小」一個打十個	sports
羅力快閃只來得及穿走外套	sports
作業員灼傷命危女兒未滿月	society
WTA台灣公開賽大小詹衛冕未知數	sports
日學者談東亞局勢：中國20年內無法取代美國	politics
整流二極體供不應求旺到明年上半年	business
蔣介石認證中廣為黨營事業	politics
亞冠賽》我1分「韓」恨今抗日搶勝	sports
謀殺獨居婦冷血水電工：殺人跟殺豬一樣	society
蘋概股變貧概股短線靜待止跌	business
遠傳攜手愛利信在台首度展演5G	business
利比亞油管爆炸比預期嚴重國際油價持續看漲	business
銅箔後市南亞、金居看法迥異	business
亞冠賽》旅日曾壓抑王鴻程找到真我	sports
標扣、薪扣額加碼？許虞哲︰有空間	business
威力盃》驚奇連連二三四名「新」紀錄	sports
1.2噸黑市價240億／台澳聯手破史上最大冰毒	society
整形男醫睡女醫開刀日即偷情時	society
《詐騙集團新招》ATM取款先找測試員	society
雙11業績中國兩大電商口水戰	business
籌組MOD頻道套餐鄭優盼拿回自主權	business
奧運棒球資格賽WBSC明年初定案	sports
糾正不得任意穿越馬路遭訐譙菜逼八衛哨兵扳倒囂張中士	society
消防員火場殉職7天後同學車禍亡	society
台灣日報大樓謝東閔女6.2億接手	business
南山人壽勞資爭議金管會要求依法處理	business
媽媽一度安慰女兒：爸爸只是睡著了！	society
處理救國團立委促各部會硬起來	politics
CBA首遇周儀翔陳盈駿飆11分	sports
裸拍族的內心戲快閃拍照以防遭白眼	society
黃國昌指控幫慶富喬5.5億貸款李瑞倉：一派胡言	politics
男詐千萬警扣700萬名車	society
妒夫雙刀闖遊藝場10幾刀剁死櫃台妻	society
世紀風電明年再增資台船擬入股兩成	business
太空人慶首冠火箭止敗雙贏	sports
夾不到娃娃動菜刀撬開機台偷高價3C	society
監事會公布不倫工會理事長告不成誹謗	society
匪連幹4票不知警盯上還在找獵物	society
搜救幻象》何子雨曾因傷停飛復飛後狀況正常	politics
Google買宏達電團隊投審會通過	business
OL沒穿內褲捷運「攝」狼尾隨偷拍	society
濃度破表！母子一氧化碳中毒亡7消進門搶救也頭暈	society
寶島吃好吃滿辛吉絲幸福胖	sports
微利恐變虧損業者意願低	business
台船揪比利時商搶離岸風電工程	business
IDF演練冒黑煙人機均安	politics
小朋友愛模仿職棒「星」教練從旁修正	sports
冰毒是二級毒品濫用恐致命	society
新北舊違建將嚴管	society
《防狼3不、3R》不傳裸照、拒視訊性愛	society
美超商拉警報無人商店AmazonGo將開張	business
掃黑除暴逮有統促黨背景13人	society
冒險划橡皮艇6小時中國情侶「搶灘」古寧頭被逮	society
財經觀測站》上哪找「最準分析師」?	business
在家玩手遊被制止怒氣帶到學校	society
獵雷艦案》台銀、兆豐都曾不建議貸款慶富	politics
一字定義2017年棒壇…「爆」	sports
強投何處覓》投手過度保護難突破自我	sports
台韓大戰比抗壓前3局很關鍵	sports
一審每年157萬案件法官一週工時超過60小時	society
謝長亨社會人隊3年年均薪破200萬	sports
小檔案》LTPS低溫多晶矽顯示器	business
財經觀測站》獵雷艦案的教訓	business
棒球路沒進展張正偉先練再想	sports
必翔炒股案外案約談7被告	business
財經觀測站》人才出超、技術入超	business
CPTPP談判顛簸加拿大商界憂心	business
翁出停車場恐怖暴衝撞斷老外雙腿骨頭外露	society
《疑虐死女童案》哥哥︰爸媽常打妹妹家暴殺人罪法辦父母	society
豐田進口小車蟬聯進口車9連霸	business
中國藉一帶一路分化歐盟議會促嚴審中國投資	business
《律師觀點》店家可向訂茶男求償	society
海上救難台日簽署合作備忘錄	politics
少年欠債文被轉PO闖高中砍按讚學生	society
四年級生、退休、女性易陷「猜猜我是誰」詐騙	society
猛男約砲注毒助性共度春宵愛侶暴斃	society
女被撿屍忍9年揭狼爪	society
冬盟》歐美投手缺工7局提前舉白旗	sports
奇景Q3營收季增3成3D感測將成主力	business
拚電子化支付公務機關刷卡明年免手續費	business
苦主寶石獵人遊走世界買原礦	society
川普稅改案美眾院過了	business
美媒鐵口直斷…大谷新人王、印人世界冠軍	sports
劉結一拒答「總統」提問我方籲正視	politics
新化派出所警帽超吸睛	society
證券行情表、證券表格	business
南英OB賽》神秘嘉賓「憲」身四爺保密到家	sports
護照烏龍外交官貽笑大方	politics
小三的復仇！寧被告通姦也要動粗郎吃保護令	society
避免慶富案重演研議三方合約機制	politics
葉倫Fed告別秀市場估升息一碼	business
婦聯會挨鍘辜嚴稱被違法撤換立委︰活在威權時代	politics
闖演習陣地2男撿廢彈殼被炸傷	society
香港再創亞洲紀錄超級豪宅每坪1814萬	business
「百萬」威力盃開打桃園直指「3連霸」	sports
黨產案馬辦︰北檢應說明誰洩密	politics
蕭俊祥甩掉中國拚新南向	business
京元電明年看好資本支出增逾兩成	business
「有聲音叫我燒車」男破窗縱火	society
桌球國手選拔賽／最想放棄的一年邱嗣樺挺住了	sports
美光在美控告聯電「侵害營業秘密」」	business
球后新搭檔詹詠然本週宣布	sports
26年志工路退休夫妻樂當更生人天使	society
冬盟》羽絨外套禦寒球員揪甘心A	sports
被撤婦聯會主委辜嚴聲請停止處分	politics
疑桃花癲變慾女妻激情咬掉老公蛋蛋	society
加速協會改革林德福今邀座談	sports
新書被聚焦選舉花媽稱劃錯重點	politics
榮成10月營收亮眼紙類股大漲	business
大福彩頭獎連43摃	society
威力盃》南市教練聽「建」言投完不先冰敷	sports
中國第三大共享單車「小藍」倒閉	business
解決MicroLED技術瓶頸傳蘋果找台積電合作	business
聯亞Q3營收季增5成矽光訂單看到明年2月	business
檢酸法院判王無罪理由歪七扭八	society
心繫住院愛子…偵查隊長速破老婦命案	society
威力盃》4局抗議「變」化改變戰局	sports
林維恩1天投209球龜山教頭坦承疏忽	sports
謝淑薇姊妹WTA女雙首封后	sports
面板訂單旺到後年志聖今年營收估創高	business
沒見過這麼「迷你」尺寸醫：低自信易導致戀童癖	society
三分彈轟爵士火箭8連勝	sports
全球最佳旅遊城市台北排名15	business
自由充電站》入札制度	sports
《母自責輕生》醫師︰勿把別人過錯怪自己	society
台北城市盃青少棒賽》陳浩恩K掉福岡二重晉16強	sports
SBL》陳侑昫起飛等4年幸得韋總慧眼	sports
拚績效…警竟栽槍又栽毒	society
一旦撤案…軍方：重新檢討作戰需求資源分配	politics
冬盟6隊今報到黃子鵬扛首戰	sports
中和大火／房東面臨鉅額求償	society
大福彩頭獎摃龜	society
新南向不比砸錢比軟實力	business
立委選區重劃陳英鈐：沒腹案沒偏好	politics
奇！僑委會推廣台灣美食列機密預算	politics
威力彩頭獎連21摃	society
央行理事︰台灣維持利率不變很妥適	business
參觀馬紹爾手工藝品展蔡笑稱很久沒逛街	politics
李杜軒下一站…已探詢羅德	sports
高調直播賣假LV通緝犯栽了	society
吳怡斌飆21分裕隆止敗	sports
警開13槍攔毒匪開車門赫見3歲女童	society
婚外情風波陳詩欣：感謝關心	sports
反制紅色黑道政黨明修法審查	politics
大樂透頭獎摃龜	society
雙載騎車撞電桿少女無照酒駕1死1重傷	society
爆米花聯盟》勝率爬過5成台電寄望傷兵歸隊	sports
太空人今推神主牌道奇死裡求生	sports
加LINE求交往獲回：哈哈哈買家QQ了…	society
馬刺落井下石艾德瑞吉41分K熊	sports
《國際現場》LGD中國OLED廠韓有條件批准	business
男足今晚「台土大戰」先被擺道？	sports
登錄實坪化增不含公設房價	business
政院都更修法4機制處理釘子戶	business
安全庫存低MLCC明年首季再漲	business
有沒酒駕刑責差很大警追手機定位查行蹤	society
彰化風電趕進度剩一案在審	business
看守所侵害接見權律師獲國賠1‧4萬	society
賓士美容被偷開車主扮柯南追回	society
國道擦撞翻車母爬出救女慘被撞死	society
走出低潮愛情、事業都有進展	society
財經觀測站》金融股的酸甜苦辣	business
虐死女童棄屍醫院返家燒炭尋短	society
土投問路》李來發：投教必須與時俱進送國外進修	sports
「忘了前痛」首戰還是陳冠宇扛	sports
PLC—電梯程式控制器	society
花媽出書揭秘辛謝長廷︰同一星座內心距離卻幾十光年	politics
「沒想到當總統親家會變這樣」台開案更四審趙玉柱當庭淚崩	society
海科館與慶陽解約仍會維持營運	politics
絲襪破洞在私處夫揪出妻搞曖昧	society
慶富案延燒》顧立雄：檢討財金官員旋轉門問題	politics
巨人首年沒做到陽岱鋼明年拚全勤	sports
拚入札無回音牧田恐回西武	sports
HBL》林哲霆留鄉打拚率宜中晉複賽	sports
不忍癱母坐輪椅探監黑道大哥「棄槍拾筆」	society
柯升完旗將與王博感情	politics
大福彩頭獎連55摃	society
想讓她看見我的世界…攜亡妻照旅遊10年	society
兒盟︰網路言行受規範應互相尊重	society
《謠言終結站》	politics
大王製紙女子高球賽》申智愛逆轉封后姚宣榆並列第7	sports
ＩＭＦ︰中國企業負債超乎想像	business
台灣詐騙犯西班牙將遣送中國	society
奪冠、娶超模韋蘭德好事成雙	sports
證券行情表、證券表格	business
基特動刀瘦身一朗遭馬林魚「放生」	sports
SBL金酒當家LogoShot送現金	sports
冬盟》梁家榮賭第一球敲平去年勝場	sports
飆57分止敗大帝生涯衝破29000分	sports
「絕對不會被打倒」林智勝赴澳	sports
探中風妻保全猝死街頭／寒風夜雨，小女孩狂喊救我爸	society
工讀遭詐5萬5驚爆超商壓榨少給薪	society
羽球》勝利女神戴資穎印度首秀輕鬆開胡	sports
21歲破3000分布克史上第4嫩	sports
美眉遭網路霸凌失聯FB告別人類陳屍溪畔	society
假孫女帶失智婦提款被真女婿拆穿	society
芝加哥戰術奏效騎士擒王13連勝	sports
「達比修＋大松井」底薪大谷高CP值	sports
共諜適用外患罪明司委會闖關	politics
北檢釋疑︰強制搜索於法有據	politics
伊藤忠擬入股101180億送走頂新	business
國道擦撞翻車母爬出救女慘被撞死	society
美稅改可望過關高盛：亞洲央行升息壓力增	business
滿滿感謝刑滿出獄月領40K	society
周駿澔扮「調和劑」老爸名氣大	sports
一週證券行情表、一週櫃檯行情表	business
鬼門關前被救回傅家慶︰張慶龍是天使	society
家暴夫警局裡毆妻打警察	society
好市多黑五三天貨一天賣光	business
躲樓梯間補眠失風高二生刺教官2刀	society
挑戰林佳龍江啟臣宣布參選中市長	politics
警政署推糾防法╱跟蹤騷擾累犯未來要吃牢飯	society
好年又逢Q4旺季設備族群樂翻	business
大谷簽名球衣飆破3萬	sports
趕婚宴逆向還飆警網友︰十足三寶	society
世界大賽》連4場開轟春天哥MVP	sports
溫泉飯店泡湯76歲翁窒息亡	society
高通發佈S845晶片搭載奇景3D感測方案	business
柯文哲動向牽動藍綠佈局	politics
【律師說法】隊長妻原諒通姦刑法告不成	society
美商界樂減稅銀行、製藥等賺最大	business
暌違44年U19男足重返亞洲16強	sports
冬盟》中職不缺後援栽培本土先發為先	sports
呂彥青簽約阪神今甲子園辦入團	sports
Q3獲利大成長永豐餘、華紙吐怨氣	business
《本週熱點》修正「鳥籠公投」12日可望三讀	politics
勇士客場6連勝本世紀第4隊達成	sports
患心血管疾病暖腳再下水10分鐘為限	society
被爆喬慶富案高市海洋局長王端仁辭職	politics
中華奧會急改選正副主席續任4年	sports
關鍵設施有「駭」賴揆促強化資安	politics
「有逃亡之虞」彭愛佳求解除境管被駁回	politics
陽岱鋼返台亞冠賽帶頭衝	sports
弱勢盤整台幣貶值3.2分	business
綠能屋頂遴選業者盼降低門檻	business
歐洲央行︰全球金融市場面臨回檔	business
桌球國手選拔賽》3個願望1次滿足李昱諄「乒」到國手	sports
台北市長找無人綠營腦筋動到菊姊	politics
道長、民俗專家說法︰吉祥樹若枯死最好連根挖掉趨吉避凶	society
老綠男陳師孟：對蔡英文「維持現狀」慼心	politics
戕害青少年冰毒侵台年年增	society
黑豹旗》雙投完封高苑平鎮拚衛冕	sports
NBA》球星耶誕送暖豪哥「照」曬姪子	sports
美光招募千名人才強化台灣DRAM製造中心	business
大帝出手續命騎士4連勝	sports
吳志揚︰澳聯、沖繩若加盟特案處理	sports
「比特幣是黃金2.0」比特幣億萬富翁自估再漲20倍	business
中概股「紅黃藍」暴跌美投資人擬提告	business
昇陽大解僱國發基金注資列評估	business
學者︰優於實坪制房價更透明	business
鈴木一朗下一站回鍋水手？	sports
川普減稅效應博通總部遷回美國	business
財經觀測站》大媽打敗巴菲特	business
當沖降稅刺激交易櫃買4指標創新高	business
台銀「最強傭兵」賈西亞單週最佳	sports
都蘭派出所超夯露營點	society
當沖降稅財長：一定會延長	business
興櫃轉上市櫃股價重挫投資人罵作價	business
磊晶缺貨客戶要貨只能給一半	business
阿特斯搶種電大餅被指外皮中骨	business
台幣貶1.1分連兩天收貶	business
INFINITI高毛利裕日車Q3EPS估逾4元	business
中火室內煤倉工程流標台電：力拚首座2021年完工	business
台塑汽油元旦起漲3角	business
裝失能詐勞保、農保3年A逾千萬首腦收押	society
美庫存增本週汽油回跌1角	business
5天不給吃、輪流毆打女惡煞虐死友判刑22年	society
許銘文遭訴內政部︰大巨蛋性能審查有效	business
首勝＆首轟大谷盼同場達陣	sports
解決紛爭免打官司司院ADR機制上路	society
共軍頻擾台美國防部︰挺台抗拒脅迫	politics
健美協會傻眼逾3千筆報名竟同地址	sports
偷拍成性！遭竹科知名公司解僱又拍清大女廁	society
雄獅董座預期明年觀光景氣微成長	business
理光盃女子日巡賽》最棒一回合盧曉晴獨走今爭后	sports
美稅改挺綠色能源太陽能股應聲漲	business
防中資假扮外資金管會祭5招	business
慎防中國小動作	politics
慶富聯貸案踩雷8行庫已提存50億呆帳	politics
去年房屋移轉數贈與繼承共占24.8％	business
強盛靠建案賺飽飽股利受矚目	business
衰匪持槍行搶遇警大集結就逮	society
立委批中片面破壞兩岸協議	politics
慶富獵雷艦案雄檢首傳熊光華	politics
非現金支付買東西消費額較高	business
塞爾提克8連勝騎士又輸了	sports
匯盛備戰9個月首度參賽就奪冠	sports
帶頭砸藝品店張榮味前司機收押	society
4項太陽能模組材料免關稅	business
yes123調查年終獎金預估平均1.1個月	business
不知李明哲關在哪李凈瑜泣：連一封情書都寄不出去	politics
郵局廉能楷模A千萬竟要全民買單代賠？	society
冬盟週日冠軍戰想邀王建民開球	sports
鄭俊聲︰寧靜中的淘汰賽將出現	business
科技股獲利了結法人看好紡織4雄	business
威力彩頭獎連18摃	society
德最大風機廠在台設亞太總部	business
歐洲議會續挺台灣參與國際組織	politics
完美2017年詹詠然由衷感謝	sports
羅德小林雅英點出陳冠宇罩門	sports
差13天退休前警所長涉貪收押500萬退休金飛了	society
港都會女子公開賽》模擬最後回合陳宇茹抗壓躍領先	sports
台股11月交易量翻倍證交稅收創6年新高	business
大摩唱衰半導體台積重挫2.87％	business
41歲張泰山熱身賽2場敲5安	sports
SBL季前系列報導》3大主將轉隊台銀寄望狀元	sports
小額終老險最熱銷7個月銷售29萬件	business
別在我家前急救…居民趕救護員	society
相約復婚毒鴛鴦被抓吞毒獲救	society
富邦長春公開賽》日本偶像挺爸18洞走好走滿	sports
穩懋今年EPS估9元、全新2.2元	business
點名貼「別人老公好玩嗎」紙條誹謗判拘	society
美聯準會估升息一碼	business
業者︰房價更混亂民眾難適從	business
大谷肘傷！天使淡定「早知情」	sports
擠下「肯塔基雙塔」湯斯「雙十」之王	sports
悅康虧損7年洪水樹照挺陳俊榮	business
商店街增資4億年底完成	business
冬盟》中職遭韓職封鎖吞2連敗	sports
慶富喊告馮世寬霸氣回應「請便！請便！請便！」	politics
正值初選陳菊新書爆秘辛謝長廷：不能慢一下賣嗎	politics
中和大火／火場2層樓隔28房包租婆月賺17萬	society
獵雷艦案雄檢傳海軍司令黃曙光	politics
中信金被罰千萬惠譽：不影響信評	business
Q4傳統淡季衝擊晶電營收估季減一成	business
豪哥新夥伴歐卡佛轉籃網	sports
施力點如錯誤斧頭破窗恐反彈自傷	society
10月出口年增3％連13紅	business
比特幣飆天價英擬採實名制監管	business
厄文加班屠牛綠衫軍16連勝	sports
中國毛巾課徵反傾銷稅29.72%	business
「奧運人協會」成立最難加入的協會	sports
德國黃金大獎賽》台灣內戰白馭珀拍落學妹晉4	sports
資產品質提升中租前9月EPS6.17元	business
在台推案失利馮侖被逐出萬通	business
中信女子公開賽》1桿氣走盧曉晴徐薇淩封后	sports
裸綁關廁所用針刺大腿╱虐同居人女兒惡女被訴	society
國泰金前10月EPS4.07元	business
協會「直選」足協開第一槍？	sports
百貨4樓墜下...男卡1樓專櫃骨折	society
一滴血破10年懸案揪蓋布袋性侵狼	society
SBL》奈維爾救援失敗裕隆2連敗	sports
蘋果布局自駕車開發導航新技術	business
躲取締花招百出警預防犯罪更難了	society
命案車庫靈異熄燈凶嫌嚇跪	society
天堂Ｍ帶橘子登上百元散戶宜留意利多出盡	business
上半月放無薪假減3家增60人	business
避免主委鬧雙包辜嚴倬雲撤告	politics
戴資穎飛杜拜挑戰羽壇空前成就	sports
《醫師看法》管教改善便溺恐是家長藉口	society
AirPods供不應求燿華、華通進補	business
迎國際移民日蔡英文邀新移民聚餐	politics
伊藤園女子高球賽》強風打2博蒂姚宣榆升上並列第2	sports
新聞幕後》賴揆：痛苦會過去美麗會留下	business
球愈投愈黏投手喬手感	sports
幼兒DVD變A片驊興勝訴免賠壓片商	society
戴后拚年終賽第3冠戰情先「劇透」	sports
散裝航運明年可望走出泥淖	business
立委︰軍方、財部各行其是釀成獵雷艦風暴	politics
中梵進行「藝術外交」外交部︰充分掌握	politics
恐怖男曾嗆：我得不到別人也別想擁有	society
4單位平分查槍績效傳士林偵查隊要吞一半	society
打敗梁靖崑是養分彭王維終於當上國手	sports
大聯盟百大飛毛腿林子偉上榜	sports
鐵蓋颱風飛砸瑪莎拉蒂牙醫獲賠50萬	society
一週證券行情表、一週櫃檯行情表	business
三星傳擴產DRAM族群聞聲嚇傻	business
鋼鐵產能過剩論壇美暗批中國	business
征服過「4顆蛋」陳禹勳仍要喬手感	sports
開高走低快艇、黃蜂吞連敗	sports
醫師︰減重手術治療半年無法減重者	society
世界大賽》爛隊翻身太空人56年首冠	sports
獲利成長延續至明年力成、華東優於同業	business
香港羽球超級賽》小戴與辛度爭后複製去年戲碼	sports
在手訂單20億元由田明年營收估增4成	business
吳敦義後天訪菲視察黨務	politics
台北擊劍公開賽》高中生擊敗大學生陳宣妤登全國冠軍	sports
中影案判刑莊婉均報到發監	politics
王建民週日返台傳承「魔法棒球」	sports
華府觀察》美台談判雙邊貿易協定，要玩真的嗎？	business
顛覆國家罪名模糊美促中釋放李明哲	politics
南英OB賽》林哲瑄關門偷催球速「牛爸」一棒打穿	sports
「董娘」調教柯旻豪神進化	sports
立委提案修兩岸條例刪「國家統一前」字眼	politics
人妻被甩自殺小王不知已婚免賠	society
涉仲介軍人當共諜菸酒商起訴	politics
需銀彈救援？尹衍樑賣金雞	business
「年近花甲」林仲秋照樣蹲捕	sports
台彩威力盃》桃園8強輸了台東爭冠笑了	sports
冬盟》減少三振申皓瑋驗收成果	sports
愛國投資人接手獵雷艦？銀行團：關鍵在國防部態度	politics
SBL》200公分溫立煌瓊斯盃翻譯圓職籃夢	sports
想收回孫中山基金會國民黨派人接觸蔡正元	politics
WHotel大廳中國男遭圍毆	society
臻鼎訂單滿手Q4營收可望創新高	business
點擊人物》168公分無極限艾圖維拚雙料MVP	sports
黃國昌罷免案挺昌、罷昌街頭互尬	politics
正副主委遭撤職婦聯會︰政治追殺	politics
綠能饋線不足列台電績效考核	business
江辰晏大解放找到信心	sports
廂型車衝撞台糖小火車7車廂翻覆	society
展望2018選股將更困難	business
地方政府整合中南部意願高	business
竹科轉型以軟扶硬明年開跑	business
精材啃蘋果股價紅通通	business
柯P：不排斥加入政黨	politics
救命三分球魏少射殺墊底鷹	sports
早布局南向金寶、廣越笑收割	politics
老太太的復仇！紅包誘餌抓菜市場扒手	society
熊抱少女搓胸狼師喘氣：好大	society
中國駐美公使嗆美：美艦抵高雄共軍就武統台灣	politics
CPR斷線「魏少出任務」大三元拔「刺」	sports
漁船高雄外海起火船長父子獲救	society
中職球員今年沒人「想自由」	sports
日職央聯「中繼王」加薪463%	sports
總算跌了！下週油價估降3角	business
8K+5G攻醫療商機鴻海超級電腦亮相	business
4300封手寫信反三接站毀藻礁	business
中國人行︰防黑天鵝、灰犀牛夾攻	business
生母男友鐵棍虐打...4歲女童斷骨穿腿慘死	society
社團管理將鬆綁許可制改採登記制	politics
分享2女泡澡直播…男評論不宜仍被判拘役	society
西部老三今年「灰」常不一樣	sports
詐6千萬喊和解又說沒錢超跑女神挨轟想騙減刑	society
雙盜隨陣頭遶境警開槍突圍逮人	society
大聯盟獎揭曉！太空人掃6獎艾圖維公認最佳	sports
救200公斤男拆門搬運就醫	society
我贈多明尼加悍馬車助人道救援	politics
全球半導體設備銷售額明年可望續創新高	business
爆米花聯盟》世青冠軍進台電蔡智榆拚亞運國手	sports
HBL》死亡之組青年靠「78連線」過關	sports
一張機票破18年欠稅案國稅局追回千萬元	business
我有妳的性愛影片…渣男騙砲慘遭圍毆	society
籌資不易4家生技業下市、讓購	business
「牢恐坐不完」4男身綁3千萬元K毒闖關	society
TPGA理事長謝錦昇接任	sports
歐盟山寨黑名單中國名列首惡	business
精英獎預測鄭兆村呼聲高	sports
10月外銷訂單創單月新高	business
偷車一路換車牌狂刷車主信用卡	society
衛星導航變迷航女開車卡山溝	society
要替爸爸顧好媽媽9歲娃堅強得令人心疼	society
高中開始纏5年降轉世新追學妹	society
兆赫︰看好4K產品拉營收	business
週末都去弄頭髮人妻原來去偷人	society
賈吉、貝林傑全票當選新人王	sports
去年手骨折呂家弘奪金驚奇	sports
美聯準會副主席川普考慮安聯經濟顧問	business
觀綠柯整合國民黨不急	politics
司機打盹⋯公車撞毀橋墩號誌桿	society
出包護照55萬本外交部︰重印才付款	politics
全球生意做不完…卓永財飛行地球120圈	business
小一生撿到16.5萬招領失主：比中樂透還開心	society
台塑汽柴油明起漲1角	business
臉書嗆殺彰中人留言來自國外伺服器	society
丟了議員寶座…柯振杯終於想戒酒了	society
台多合破跨國詐騙3調查官功勞大	society
中國打壓無損台灣經濟我多項指標排亞太前段班	business
國家人權博物館明年5月掛牌	politics
歐日EPA敲定逾9成關稅取消	business
殷仔談投球失憶「不說」是下下策	sports
勞基法修法林美珠：會加強把關機制	business
中正大學眼鏡狼電擊勒頸夜襲女大生	society
泰山Q3擺脫虧損漳州廠是最大包袱	business
威力盃》李振綸制霸5局台東封王	sports
開性愛毒趴11愛滋男全不戴套	society
顛覆國家罪名模糊美促中釋放李明哲	politics
SBL》裕隆3月主題週汽、機車大方送	sports
藍擋10次共諜納外患罪草案終付委	politics
《謠言終結站》蔡政府新官職缺多了324個？人事總處︰只有95個	politics
立院決議︰黨產會與婦聯會簽約前須先報告	politics
合庫遭槍殺陽光男下月要當新郎官	society
估6年逾48億元小熊搶達比修	sports
薛哲連莊塞揚3度獲獎等當爸	sports
裸拍族攻陷新竹無視路人她照樣露光光	society
性交易糾紛不起訴反被揪出18年前性侵惡行	society
林志祥自請離隊下一步崇越?	sports
中職年終盤點誰是「薪」亮點?	sports
挑戰東奧半喜半憂台灣隊何處覓強投?	sports
邱議瑩出書分享抗癌「同班同學」賴揆讚俠女	politics
立委：有中將級以上人物意圖放水慶富	politics
國防部出手沒收慶富7.2億	politics
抬棺逼債只算妨害安寧檢不起訴	society
J聯盟25年讓日本小孩棄棒從足	sports
基本工資3萬經長︰中小企業較辛苦	business
《世新說法》陳生曾要求輔導承諾不再追求	society
醫師娘偷吃裝潢工內褲有異味洩姦情	society
翻修外牆未繫繩索男重摔4樓不治	society
林昀儒、蘇珮綾青奧「桌」到手	sports
毒品是萬國公罪跨中線照樣可抓	society
國台辦︰堅決懲治電信詐騙	politics
新北之爭綠營輪流點將藍營侯、周搶出線	politics
脫序勞團癱交通柯︰超過底線	business
立院三讀尉校軍官可延役二年	politics
「薪」亮點》陳鏞基想續當「複」翁	sports
鴻海、英特爾結盟啟動5G刷臉應用	business
建仔真心話這一年空白很茫然	sports
侯貞雄出書誠義見證台灣鋼鐵史	business
聲援李明哲文大生繫黃絲帶	politics
上季GDP成長3.11%全年有機會2.42%	business
少年仔安啦尼克、七六人寫連勝	sports
台彩威力盃》扳倒衛冕軍桃園「沙漠」雲林一戰成名	sports
仲介援交試車白嫖惡男緩刑期間再犯	society
日矽合效應矽格傳結盟天水華天	business
照顧「毛小孩」殷仔專款贊助	sports
學怎麼教／阿三留營觀摩意外挖到「伸」喉嚨	sports
林聰賢︰改制擴大灌區可服務更多農民	politics
偷2887萬元珠寶1折賤賣╱櫃姐毫無悔意重判16年	society
刺青可畏!1字逮到蠢車手	society
史上最溫馨喊話警勸服跳樓女	society
國民法官參審法官憂審判淪馬拉松	society
少年高調放炮慶出獄滋擾送辦法官不罰	society
防市場派搶經營權泰山現增1.47億股	business
審查無共識世亞盟預算保留朝野協商	politics
永豐餘新廠產能增搶高價清潔品商機	business
聯發科前共同營運長朱尚祖跳槽中國小米	business
殺警案富少曾威豪二審判更重	society
艾利克森帽子戲法丹麥重返世界盃	sports
整建地方部隊吳敦義元月閱兵	politics
搶大谷最後淘汰賽教士有自信	sports
川普今訪中卜睿哲：美不會犧牲台灣利益	politics
恐「剝三層皮」中小企籲營所稅維持17％	business
穿梭馬路賣玉蘭花老婦慘遭輾斃	society
出席APEC宋與美次卿雙邊會談	politics
熱愛馬拉松／警界徐懷鈺跑百米擒通緝犯	society
中信女子高球賽》盧曉晴拚連霸暖場秀對決恰恰	sports
台灣38家銀行施俊吉：符合壟斷性競爭	business
中國審查延遲日矽合拖到明年10月	business
MLB》「錢」景無限好大聯盟營收破3千億	sports
市場不看好！高鑫股價跳水	business
邱義仁籲日支持台加入CPTTP	politics
憂鬱症姊妹自戕1死1重傷	society
興大附農搶季軍林奕丞連5天登板	sports
球場赫見「兩岸一家親」兩岸學生棒球賽走味	politics
慶陽BOT案監院糾正土銀、海科館	politics
魏少生日喬治宰牛送禮	sports
汽油不調價柴油漲1角	business
一朗價值超凡美媒撮合7球隊	sports
醒吾高中：將加強門禁	society
醫師︰過度換氣會出現激動、幻覺	society
YY棒球訓練營》榊原良行一席話點醒王勝偉	sports
「台灣沒有職業隊」李茂道出國腳無奈	sports
HBL》譚傑龍火鍋秀泰山仍輸能仁	sports
10多萬支窗簾釘撒滿地11輛汽機車中招	society
比特幣狂飆瀚荃錢包訂單滿滿	business
導入信用卡支付統一超、全家較勁	business
澳門羽球黃金大獎賽／台灣雙李配衛冕路已抵8強	sports
借提開庭突抓狂空手打趴4法警	society
資通電軍指揮官馬英漢：謹慎處理網路攻擊	politics
外商銀行放款門檻金管會鬆綁	business
艾圖維無極限這次擊敗布萊迪、大帝	sports
爆米花聯盟》9局上強迫取分興富發險勝	sports
嬰兒啥都不懂帶離險境是唯一方法	society
冬盟》洪聖欽拚先發投到大腿快抽筋	sports
司機大盜出獄又搶運將、砍警察	society
SBL開幕日霸主達欣12/2尬裕隆	sports
立院三讀尉校軍官可延役二年	politics
內外資皆賣蘋概股派對謝幕？	business
夫妻闖貨櫃屋燒炭留下５個月大女嬰	society
吸金大法慣用5花招	society
檢再傳陳慶男父子與簡良鑑詐貸部分擬年底前先偵結	politics
日明星隊有套SOP台灣學不來	sports
LINE購物詐騙猖狂65組ID千萬別加好友	society
西武新人卡位吳念庭微減薪	sports
國民黨慶任「一日主播」推崇蔣經國與鄧小平立委諷吳敦義想回到威權美好年代	politics
李明哲被判刑陸委會：滾動檢討兩岸政策	politics
台南母子燒炭亡7歲兒輟學9個月	society
UBA》健行大勝台體大並列龍頭	sports
223隊搶到4強北勢孩子感動教頭	sports
併購王陳霍克鯨吞同業一樁樁	business
周儀翔西進張家榮扛達欣一哥？	sports
「冰風暴」今完結篇？釋出潮受關注	sports
大樂透頭獎摃龜	society
大同疑遭禿鷹炒股市場派向北檢告發	business
大谷、楚奧特奇緣同日迎人生大事	sports
吹哨者保護入法兩週定案公布	business
宋美齡兒童血癌中心婦聯會隱匿未報	politics
無權要求登山零風險博崴國賠案二審逆轉免賠	society
OPEC延長減產油價飆高	business
「魏少」爆扣超人秀附送大三元	sports
SBL》台銀開門紅就靠雙後盾	sports
余定陸︰台灣半導體競爭力領先中國	business
和運iRent自助租車今年佈建250據點	business
法遵成本增賺錢時機漸失	business
Q.戴維斯「犯滿」台遭菲逆轉惜敗	sports
20萬換機要秘書台中和平區長被控賣官	society
王品越南菜、麻辣鍋明年衝業績	business
電梯夾死校醫竟無人需要負責	society
飆破10000美元比特幣8成崩盤？	business
比特幣期貨美核准上市	business
「我與史總間和諧」被冷凍更玄	sports
中國共享泡沫頻爆酷騎1年就倒	business
《威力彩》頭獎連27摃	society
快去加油！台塑汽柴油明起漲6、7角	business
大馬淨選盟獲亞洲民主人權獎	politics
于煥亞的低潮驚動球迷奮起救台啤	sports
賴揆︰在野杯葛促轉民進黨背黑鍋	politics
藍委譏發配東瀛謝：在講蘇武牧羊喔	politics
抗手榴彈總統座車上週交官邸	politics
開出亞洲第1槍南韓升息一碼	business
NBA》柯瑞下半場開機止鵜鶘連勝	sports
金管會︰緊盯總行「管好海外分行」	business
7遭釋兄弟全員反擊林克謙︰勿再無的放矢	sports
中職選秀落榜蔡子凡明年再來	sports
SBL》黃聰翰手感回溫20分灌倒達欣	sports
憲政空窗期誰准聯貸慶富？藍綠都籲徹查	politics
台灣足壇質變「職業化」已不可逆	sports
半月來新高台幣升3.5分	business
「我沒放水」陳鴻文要告壹週刊、三立	sports
自由市場大魚達比修仍居榜首	sports
機車撞倒Ubike少年醉女拒測盧小小	society
NBA》卡特回多倫多賞老東家麻辣鍋	sports
國發會明年三大重點工作數據開放、地方創生、智慧城市	business
躲進公設上吊豪宅無端遭波及	society
冬盟》林立勝打贏南韓中職5連勝平紀錄	sports
教練施獨門「暗器」南湖晉8強	sports
對女店員襲胸K頭「澳」客醉鬧夜店	society
世界盃資格賽》台菲後天對戰FIBA︰宿敵交鋒	sports
YY棒球訓練營》最難對付投手林子偉點名田中	sports
大樂透頭獎連2摃	society
「吳賴會」手牽手談政務互相按讚	politics
土投問路》石井一久：投打若長久不均衡國際賽吃虧	sports
亞冠賽》日韓戰今揭幕台灣全隊現場緊盯	sports
男足爆冷大勝「菲」李茂再扮殺手	sports
江辰晏改變節奏6局好投	sports
陽介仁勾魂手中職經典傳奇	sports
為愛開球曾仁和緊張	sports
聯邦銀夢想列車邀認養心願	business
11/30威力彩頭獎連26摃	society
馬紹爾總統口誤稱蔡「中國台灣」總統	politics
政黨對話王金平籲先雙邊會談	politics
增產或備貨矽晶圓族群拚增資	business
12年西武情許銘傑將續前緣	sports
特勤中心副指揮官林文豪周廣齊呼聲高	politics
吳宏謀轉任港務公司董座吳澤成兼任工程會主委	politics
蝶戀花車禍》周比蒼父子不起訴民事官司恐有得打	society
風電熱身六案通過環評	business
因傷錯過半個球季岱桑︰對不起球隊	sports
大聯盟年度MVP艾圖維小霸王史坦頓小幸運	sports
射傷騎士…車行老闆被抄出16把槍	society
星期專論》虛構的不能當基礎	politics
4大案拚3讀立院臨會將開1個月	politics
綠衫軍15連勝厄文有感觸	sports
掏空幸福人壽127億鄧文聰判10年定讞	business
MAZDA台日青棒賽》得點圈攻不下平鎮吞首敗	sports
鵜鶘飆18顆3分球不敵「哈羅連線」	sports
柯瑞解牛單節得分抵全隊	sports
10月景氣降5分守住綠燈	business
智慧城市徵案第2期增自駕車	business
酒駕男撞恆春古城門妻企圖頂罪	society
保羅扮救世主火箭12連勝	sports
郭婦和善生活單純繼承夫土地成包租婆	society
疑A柱擋視線小巴司機撞死祖孫	society
寶馬男闖紅燈撞死休旅車水泥工	society
為台灣祈福聯邦銀裝置藝術展登場	business
60警、消冒險救命跳樓男被網友譙翻	society
樂陞股東會3度流會最快明年1月再開	business
紀政挺體改「不要三分鐘熱度」	sports
公告毒品牌價高調販毒收押	society
續門號搭家電掃地機器人最熱賣	business
遲交海巡艇慶富藉口「一例一休」	politics
復刻職棒元年開幕戰陳瑞昌101觸搶戲	sports
拒酒測攀升民團︰應比刑事罰金罰更重	society
美批中國扭曲經濟拒授市場經濟地位	business
慶富地雷引爆9聯貸行面臨125億虧損	politics
2.7萬「追夢」人明台北開跑	sports
馬：是否統一由兩岸人民決定民進黨批馬背離台灣主流民意	politics
監理沙盒跨國實驗洽簽MOU鋪路	business
里拉德絕殺三分對湖人13連勝	sports
戴資穎復出獲加冕教練：腳程恢復	sports
中視交易案北檢再傳喚指認錄音帶蔡正元︰聲音很清楚是誰	politics
亞錦賽》「女壘大谷」逞威日本5連霸	sports
赴美逐夢高國豪扮先發A咖	sports
中職強調不護短歡迎提供事證	sports
西武接觸許銘傑想託付台將任務	sports
冬盟》林立勝打逆轉日職東軍	sports
《疑坐檯養家惹殺機》裸女確認死後遭扔屍	society
中日龍看上松坂？恐領一軍最低薪	sports
神秘婦扛百公斤硬幣繳房貸銀行拒收挨告	society
美稅改可望過關富人、大銀行最受惠	business
高球》潘政琮開課短桿體訓打基礎	sports
勇奪新人王詹子賢月薪上看15萬	sports
幻象全面停飛尚無封存、汰除計畫	politics
經營知名米店阿輝伯曾留影	society
連德安拚進冬奧台將第3人	sports
南韓全馬傳奇台北馬拉松站台	sports
CME比特幣期貨起跑暴漲又暴跌	business
港都會女子公開賽》首度回家比賽蔡佩穎並列第1	sports
稅務資訊自動交換反避稅邁大步	business
包偉銘子撞車7傷花300萬還有2人未和解	society
行政契約卡關婦聯會開條件逼黨產會讓步	politics
薛瑞福：優先投資安全夥伴台、星	politics
港版「世大運紀錄片」國旗遭馬賽克柯批中國打壓	politics
第3節轟垮對手勇士並列西部一哥	sports
台電二期離岸風電初審過關	business
民進黨縣長提名台東劉櫂豪、南投洪國浩	politics
欠賭債？15歲少年遭22人持刀狠砍	society
統一證︰明年股市震盪加劇	business
上季GDP成長3.11%全年有機會2.42%	business
電競納運動產業享國光獎章	sports
10年債殖利率面臨1％保衛戰	business
單親爸泡湯猝死自閉症子枯等他身影	society
馬林魚第一波精實名單沒有陳偉殷	sports
火鍋店未替員工投保彰縣府將究責	society
偷拍女店員如廁阿兵哥扯「男廁滿了」	society
汐止少棒淚收亞「盜俠」點出敗因	sports
看好NAND快閃記憶體向上成長潘健成：群聯3年內獨霸市場	business
送便當受阻外送員撂人搧保全耳光	society
政黨法三讀／政黨補助門檻降為3%	politics
金士頓、威剛仍看好明年	business
攜手北京萬維集團大宇資進軍國際	business
傳收購東芝ＰＣ？華碩不評論	business
爆米花聯盟》陳晨威猛打拚少棒後再當國手	sports
台灣大賽》猿下重手聽牌象迷6局就散場	sports
面板訂單旺到後年志聖今年營收估創高	business
境外犯罪判刑回國得再受審判	society
共諜鎮小江假釋初審通過	politics
違建大火屢奪命立委推租屋吹哨者條款	society
耗14小時大谷「面試」完畢	sports
軍方曾擁有妙天也經手	business
《家防中心》越打罵越易犯錯應儘早就醫	society
女騎士遭射穿臉柯P:馬路練靶是瘋子	society
學怎麼教／阿三留營觀摩意外挖到「伸」喉嚨	sports
「地方創生」再深化7縣市獲加碼補助	business
球評王雲慶︰6分的差距中職須自強	sports
研發不設限中科院意外開花結果	politics
淚汗交織2017年10大風雲戰將出列	sports
車用線束升級宏致明年放量出貨	business
退休後靠自己終老逾7成民眾沒把握	business
政院組改過渡期再延至2020年	politics
Nike青棒訓練營》催出143公里陳柏毓最佳投手、MVP雙贏	sports
共諜鎮小江假釋案複審被駁回	politics
一味禁止非上策可尋求第三方幫溝通	society
證券行情表、證券表格	business
亞冠賽》今熱身賽羅德內戰陳冠宇不保留	sports
越南習俗偷盆栽可讓生意興隆？	society
鐵皮工廠延燒9小時百餘消防員寒夜打火	society
國民法官參審陪審表決平手	society
日本一》橫濱行不行?0勝3敗後逆轉勝	sports
運動員第二春系列報導／三商虎陳正中改名榮登餃餃者	sports
暴力男押人少女急求援…救出被打成貓熊眼媽媽	society
集體收賄包庇電玩6官警最高判18年6月	society
球哥手感冷命中率不到3成	sports
神達車聯網收割獲美政府車隊訂單	business
「你們完成了我的夢想」第一代AIT官員開心台灣飛躍進步	politics
帛琉邦交亮黃綠燈李大維坦言傷腦筋	politics
同一地點／空姐才被潑糞又遭潑滾燙瀝青	society
利誘促統國台辦︰逐步給台胞同等待遇	politics
校安保全竟是大「攝」狼	society
不甩中客不來金門見近億元實價	business
陳炳男絆倒兒子說是「飛撲」	sports
金融時報：防中國駭選舉民進黨升級網安	politics
一罪一罰戀童狼最高可判30年	society
褪18年黃衫王金勇轉美職球探	sports
啟動四引擎時代開發金鎖定高槓桿業務	business
《財經觀測站》豬隊友與「裂」士	business
困山區7天撞見熊薄衫男靠「賴打」脫困	society
NBA》感恩節休兵豪神曬舊照放閃	sports
兒驚覺老闆娘非親娘揭董座父30年婚外情	society
把關鬆散肥中企瘦台廠	business
李大維：台索邦誼不變總統行程照走	politics
兒酒駕害一死一重傷航空城總座:他須自己負責	society
馬讓利高於中視撤照損失?檢將追查	politics
溫馨接下課變悲劇！父頭暈自撞女兒彈飛亡	society
台日關係缺口謝：用堆積木補強	politics
財經觀測站》中國鬆綁投資外資真的吃得到？	business
南亞科11月營收57.44億創近8年新高	business
11月外匯存底4504億美元續創新高	business
德國桌球公開賽》日萌妹組合好殺靜思配首冠落空	sports
2聯盟塞揚強投哈勒戴墜機亡	sports
台灣之光內戰！運動精英獎戴資穎坐一望三	sports
走私史上最大宗海洛因／船長運毒判無期徒刑	society
跨足物聯網至上結盟中國兩集團	business
親友臉書拋售iPhone…一週騙128人匯錢	society
博通︰若買下高通將大改授權業務	business
關懷盃》人小鬥志高三星國小暌違12年奪冠	sports
Apple六大機殼供應商法人：首選可成、鎧勝	business
輸人不輸陣！SBL尬場效應「正循環」	sports
黑豹旗8強賽麥寮今強碰高苑	sports
足球》主場5連勝教頭懷特：繼續贏	sports
解高通案經部樂見雙方坐下談	business
工業用玻纖布吃緊台玻今年可望轉盈	business
陳慶男：有個百億男想接手造艦	politics
放黑假、A12萬津貼被免職消防科員2000萬元飛了	society
美食-KY重返400俱樂部	business
社區管理員阿伯涉帶女童上摩鐵	society
10槍砰死角頭殺手判19年定讞	society
Dyson訂單倍增金寶明年Q1產能滿載	business
威力彩頭獎2注中各分5.8億	society
阿貢火山亂賽程台灣男足連踢3天	sports
未談新南向ＡＰＥＣ效益打折扣	politics
印僑返台宋大江擴大房產布局	business
自謙不比高國豪陳將双孵美國夢	sports
網友跪求載點「上車」極樂群交趴北檢擬調查	society
破壞銀樓木板隔牆賊費心「跡」白忙一場	society
除右肩新骨刺郭泓志鳥8度動刀	sports
醫師︰性行為後恐影響尿檢	society
泳隊高中生趕晨訓撞違停大貨車不治	society
二哥地位不保我半導體產值今年被韓超越	business
已罰21萬判5年9月仍不怕…醉男第12次酒駕	society
粗心爸外出買消夜2歲女童懸4樓窗外	society
爆米花聯盟》6人雙安護航前犀投許文錚奪勝	sports
NBA》七六人不賞臉魔術吞8連敗	sports
同日飆40分以上命運大不同	sports
哈登帶動唱火箭3衛宰湖人	sports
羽總明年新賽制小戴1月上工	sports
迴避藻礁》第三接收站新案中油拚明年6月動工	business
矽晶圓明年估漲3成客戶簽長約高達8成	business
國際品牌縮減供應商台廠紡織業組國家隊	business
黑豹旗》78球K掉大理岳政華最想三振哥哥	sports
國道自撞車毀安全帶救了1家4口	society
國產化分階段先基建後零組件	business
HBL》松山教頭祭鐵腕林勵被逐出板凳	sports
服勞役掃狗屎罵狗主人「狗奴才」被訴	society
學怎麼投／羅嘉仁3天體驗有效就赴佛州	sports
救火遇「爆燃」裝備瞬間燒融	society
軍人年改草案李翔宙：六成退伍軍人接受	politics
挑戰林佳龍江啟臣宣布參選中市長	politics
財經觀測站》這種內線交易還抓不到？	business
「乒」輸舊仇家「奶爸男雙」季軍作收	sports
世界盃資格賽》一軍好手沒來澳洲還會更強	sports
南韓率先升息台幣淡定小貶	business
高院院長石木欽升任公懲會委員長	society
應召站情色廣告入侵幼兒園網站	society
騰訊入股中型公司挑戰美四大科技龍頭	business
厄文射鷹綠衫軍9連勝	sports
無線充電題材發燒IC設計看俏	business
哈登神鬼56分好比喬丹張伯倫	sports
上銀獲利步步升目標價喊到350	business
「直選」改革41個協會響應	sports
罷昌說明會孫繼正、黃國昌激辯同婚、涉賄	politics
冬盟》迪恩猛打3分砲歐美聯軍開胡	sports
精英對決鄭兆村、郭婞淳稱帝后	sports
搶鐵飯碗！油電糖水招考錄取率僅5.84％	business
助慶富解套？王定宇點名吳志揚	politics
少年仔安啦尼克、七六人寫連勝	sports
亞馬遜中國雲服務資產賣中企	business
台日青棒賽》平鎮完封大阪李晨薰報2箭之仇	sports
豪哥感激「前隊友」傳授秘招	sports
「你看起來像40幾」25歲女毒蟲瞬間淚崩	society
連4年失冠掀釋出潮?中信下週討論	sports
雷霆換戲碼「CPR連線」演逆轉秀	sports
女騙旅館住2個月偷7萬開溜	society
比特幣狂飆瀚荃錢包訂單滿滿	business
獵雷艦35億預算立院砍光	politics
MAZDA台日青棒賽》高苑張景淯飆14K完投勝	sports
詐騙有新法可治判10年還可強制工作	society
23立委提案修證交法妨礙獨董執行業務最高罰240萬	business
黃國昌罷免案成案12月16日投票	politics
共機掛彈演訓官網嗆「繞島巡航」	politics
週一起台塑汽油不動柴油上漲一角	business
「投」葉總所好陳仕朋開季先發候選人	sports
台北海碩盃女網賽今天開打	sports
躉購費率又降業者：違背綠能屋頂政策	business
遠傳與46廠商合作成立物聯網生態圈	business
國人樂於投資比率全球之冠	business
打撈幻象今抵失事海域	politics
安成藥買景德恐先賠2年	business
15歲女學生當性玩伴狼師車震被警抓	society
HBL》賞淡商首敗普門「死守」連勝	sports
法務部︰堅持司法主權沒變過	politics
冒充新加坡警察跨海詐4.4億	society
公司法大修1年可分派兩次盈餘	business
松井當洋基說客大谷二刀流也OK	sports
認內線交易╱外資圈第一美女夫婿求緩刑	business
3000人慶開幕達欣甩尾逆轉勝	sports
體育署長林德福︰改革非做不可已有半數協會響應	sports
INFINITI高毛利裕日車Q3EPS估逾4元	business
金管會5措施鬆綁證券商大利多	business
「盜帥」開賽就盜葛雷諾神預言	sports
不滿今年表現吳念庭學當工具人	sports
林萬億︰軍人月退地板將高於三萬五	politics
彭淮南接任者面臨三大挑戰	business
小戴「年終」衛冕失利后座安啦	sports
國民黨搶救遭凍結資金法官：訴訟程序有疑義	politics
夫家經營澄醫謝式冰背景顯赫	business
看問題》兩岸關係破壞者	politics
幫製毒假釋男又擁槍彈送辦	society
星期專論》美麗島的探索者	politics
台中外役監強盜受刑人跑了	society
賴揆首表態爭取加入CPTPP	politics
重劃區爆量閒置土地一大堆	business
冬盟》南韓恢復社會人隊柳承安直言很難	sports
大谷適用入札舊制耶誕前確定新東家	sports
多利用老人日托可減緩照顧壓力	society
HBL死亡之組泰山、能仁預賽碰頭	sports
撞死人去喝酒？賓士男消失半天才投案	society
彭双浪看好MicroLED「台灣的好機會」	business
桌球國手選拔賽》關鍵第一次方思涵淚續桌球路	sports
網拍贓物SOP…上午得標下午就到賣場偷	society
《輔大性侵未遂案》學弟判賠學姊90萬	society
一句不要停律師：具殺人默示合意	society
《書劍集》主計總處又開始悲觀了	business
iPhone下季出貨恐大砍40%	business
會網友關手機搞失蹤漂亮寶貝嚇壞爸	society
「王」牌助教點化「恰恰」有強投架式	sports
喝茫搶警棍襲警被逮酒醒好懊悔	society
雷倩展誠意婦聯會財產暫緩凍結	politics
古厝拍片驚魂男大生掉進古井	society
新書揭抗癌歷程邱議瑩：我終生不孕	politics
慶富詐貸案傳幕後有淡江幫藏鏡人	politics
達比修難留道奇尚無球隊喊聲	sports
慶富7億餘還款保證金繳庫	politics
校醫枉死之後…電梯程式控制器納檢測了嗎？	society
中國以國安為由阻外國自駕車路測	business
一週大事（12月17日至23日）	politics
助視障過馬路消防暖男善行曝光	society
戴資穎復出獲加冕教練：腳程恢復	sports
中國漁船金門沉沒1人游上岸2失蹤	society
元太Q3毛利率46.9%創新高	business
《財經觀測站》上班族的貧富差距	business
海碩盃美麗戰爭開打俄女「衣」戰成功	sports
不再用3碼數字空軍戰機聯隊下月更名	politics
國民經濟信心30月來最樂觀	business
勸說安靜惹煞店東、員工3人挨槍	society
SBL》胡凱翔飆24分裕隆打虎	sports
國民黨桃園市黨部主委：對手太強了	politics
《書劍集》經濟排名大賽的下一站	business
年終賽拚第3冠戴后「有始有終」	sports
關懷盃》張正偉不旅澳還是想拚中職	sports
幼女託付男友...母：「我很放心」	society
民進黨9縣市長拚連任29日共同造勢	politics
比起公教軍人年改較優渥	politics
土虱後繼有人李晨薰飆出148km	sports
《酒駕零容忍》中市警白天抓酒駕	society
《財經觀測站》從大立光加薪談起	business
SBL》金酒加菲貓搶戲主場週首奪2勝	sports
中國海航收購澳盛融資業務紐西蘭否決	business
離岸風電輸電台電衝十．六五ＧＷ併網量	business
月餘未實戰林樺慶今亢奮登板	sports
證券行情表、證券表格	business
台達電工業自動化收成電動車起飛	business
義賣競標價恰恰只排到第3	sports
新店戒治所「去蔣」移除銅像基座	politics
從小立志從警任職7天車禍亡	society
台股首次萬點封關年漲15％	business
（財經觀測站）內需復甦力道左右明年景氣	business
后的高度戴資穎參選羽協理事	sports
SBL》璞園交換禮物吳岱豪中「大獎」	sports
太陽能報價連跌三週電池摔最重	business
中職第5隊沖繩也有意願	sports
撞進金春發麵店駕駛是殺警案共犯	society
專利權鏖戰高通再告蘋果暗助英特爾	business
Google預期明年起上億Android手機可用AR	business
預期出口減緩瑞銀︰明年台灣GDP遜於今年	business
大福彩頭獎連41摃	society
NFL黑豹要賣柯瑞想當老闆	sports
立院決議︰黨產會與婦聯會簽約前須先報告	politics
「要甜私我」網遊聊天室淪販毒天地	society
澳聯》蔣砲單場雙響躍居全壘打王	sports
政治受難者家屬︰盼父輩鮮血沒白流	politics
威力彩頭獎連4摃	society
交互破風馮俊凱雙金落袋	sports
國中生戀上大姐姐母爆氣報警尋人	society
朱育賢升格當爸趕回家看「寶貝」	sports
SBL》達欣嘉年華和布拉比身高	sports
暴龍6連勝喊卡盟主一日遊	sports
冬盟》側投下勾分不清黃子鵬：這就是我	sports
學者︰中國視政治標準高於交流	politics
《國際現場》三星攻晶圓代工難敵台積電	business
拚金融科技金管會擬設數位沙盒實驗室	business
麥電8年後改燒天然氣	business
舢舨翻覆淡水河口3獲救2失蹤	society
客戶渴望智慧製造盟立自動化設備商機大	business
哈登飆38分無用遭暴龍逆襲	sports
冷眼集》國安的缺口	politics
林琨瀚兒子不走棒球路	sports
警方掃黑查獲桃園黑道皇帝擁槍	society
台灣精品Latina遭逆轉黃培閎第4局上陣	sports
秋鬥凱道怒吼小豬撲滿丟還小英	business
747勝教頭牽線一朗轉戰墨西哥?	sports
符合「規則5選秀」張育成叩關40人名單	sports
哈登51分不夠花火箭止14連勝	sports
赴多明尼加設機房4年詐1.5億	society
Nike銷售轉型儒鴻受激勵大漲	business
亞冠賽》日韓評臂力差嚴宏鈞一笑置之	sports
違建惡火奪命二房東隔22房賺20年	society
亞冠賽》收集中職球衣日球迷就愛台	sports
剋韓大爆發中職「前2」晉級	sports
婦聯會協商葉俊榮樂觀：短期會有結果	politics
《大福彩》頭獎摃龜	society
撒冥紙討債挨告發洩情緒非恐嚇	society
詹詠然新拍檔大有來頭	sports
海碩盃開打美女球星掉滿地	sports
《華南王子新光公主婚變》裝GPS監控妻法官認證無罪	society
酒店紅牌變身陽光女色誘富商生日賞百萬	society
安卓陣營拒付高通授權費華為開第一槍？	business
冬盟》韓職狠打臉中職只能爭季軍	sports
趕祭拜兄長頭七婦遭貨車逆撞一起走了	society
在竹科草地性侵同業噁男珍藏沾精帶血戰利品	society
全球入境計畫爆量美方元月來台面談	politics
台日棒球3傳奇新球季去哪裡？	sports
朝野都買帳賴揆首戰輕騎過關	politics
談旅外追夢林子偉坦言「心理震撼」	sports
林煜清不甘背負「難溝通」罪名	sports
國道6車連撞火燒車3死2傷	society
酒駕撞死烘焙師落跑金錢豹酒女被求重刑	society
伊拉克石油部長盧埃比預期：油市明年首季達平衡帶動油價上漲	business
關懷盃月底開打江忠城切割「冰風暴」	sports
理事長開放直選足協從善如流	sports
上回拒警借監視畫面這回換他家銀樓被搶	society
秘訓後「試刀」蔡齊哲設定60球	sports
中國信託HomeRunTaiwan50週年年鑑熱銷	business
第3接氣站延1年趕不上救急	business
基特贊助25萬美元洋基簽大谷添籌碼	sports
《財經觀測站》末升段必有妖孽	business
亞冠賽》做好守備不是沒機會取勝	sports
跨國反毒台灣和多國連線	society
新聞辭典︰工業用玻纖布	business
黨員提議建立大量網軍吳敦義：適切可行	politics
花300萬查女友親屬叫人潑漆又刺車胎	society
財經觀測站》賴揆掃雷	business
3萬元財務糾紛男遭圍毆砍死	society
恩比德掛傷號七六人禁區成迎賓處	sports
「台灣噴射機」開幕週最佳球員	sports
減稅賺到了美大公司發員工獎金	business
「你防彈衣很厚？」竹聯信堂賣衝鋒槍不買還被恐嚇	society
世界盃資格賽》211公分布拉契台「守」要目標	sports
勞動部政次廖蕙芳請辭	politics
大谷送耶誕禮回札幌謝球迷	sports
3D感測資料量大高通推加密晶片把關	business
不老新台客SBL上週他最威	sports
台電補助救國團辦「愛迪生」活動立委批「掛羊頭賣狗肉」	politics
開出亞洲第1槍南韓升息一碼	business
醫界：控制血壓、避免壓力太大	society
親密互動須尊重對方感受	society
女按摩師「做清的」尋芳客揍人砸店	society
慶富案》簡太郎控誹謗黃國昌批害國人損百億	politics
MLB》張育成進40人名單林子偉：他會比我更搶手	sports
洩密案高院首度開庭／檢︰一審誤解憲法原意馬︰蔡也推動院際協調	politics
獵雷艦案慶富爛攤軍方最快月底解約	politics
缺角的綠衫軍衝出45年來最旺開季	sports
台灣大賽》猿下重手聽牌象迷6局就散場	sports
失聯幻象飛官何子雨結婚才週年	politics
台灣隊「側」重》大鵬展翅黃子鵬出奇制勝	sports
法官開車被撞肇逃重回現場自首	society
立院休會通過69法案	politics
詐騙車手輸錯密碼帳戶6720萬只領84萬	society
7年200億歐元福斯將推80款電動車	business
中信女子公開賽》徐薇淩領先今搶后冠	sports
小瑞佛斯砍30分幫不了教頭老爸	sports
西部雙霸一樣勇10勝登頂	sports
華邦電聯手以國團隊設立研發中心	business
建仔情義相挺盼棒球農場助台灣	sports
日學者談東亞局勢：中國20年內無法取代美國	politics
遇恐怖情人勿激怒求助師長	society
台代工廠加速脫離中國	politics
亞冠賽》郭阜林扛三壘衝觀眾席守危機	sports
變裝盜騎YouBike10秒偷1台機車	society
大樂透頭獎摃龜	society
「CPR」連線啟動引擎火箭遭轟墜落	sports
明年上半年投資9成理專看好會賺錢	business
亞洲社會人球隊漸縮南韓沒半隊	sports
馬批黨產、促轉條例綠促坦白交代三中案	politics
這次是真的了陽冠威遭釋出	sports
連兩年來探班蔗總現身冬盟	sports
葛雷諾評王維中：將成頂尖後援	sports
諸羅山盃》張趙紘一夫當關連2天完投日本	sports
TensorFlow課程明年上線	business
公平會罰高通林百里：搞出很不利變數	business
慶富找百億男救火軍方：底線不變	politics
美國會報告建議邀台參加軍演	politics
慈母緊抓尋短兒力竭目睹他墜樓	society
獨眼奧斯丁準！裕隆淨贏10顆三分球	sports
SBL季前分析》達欣連霸路布拉最關鍵	sports
洪總不得閒10日督軍戰羅德	sports
本週熱點》3青棒名校選同天OB賽	sports
財經觀測站》27兆的大泡沫	business
強投何處覓》短期投手營效果「點到為止」	sports
踏進東京巨蛋朱俊祥如願了	sports
急想抓賊未熄火警車反遭賊開走	society
城市青少棒賽》頭被砸送醫無礙水鳥歸位猛打	sports
東部「第一控衛」之爭沃爾強壓厄文	sports
停黑色停車格挨罰阿公到交通局潑糞	society
馬建豪覺醒松山驚險保勝	sports
SBL季前分析》金酒大換血老將帶頭衝	sports
最有型戴資穎今戰最潛力新星	sports
慶富資本額不到半年從5億變30億	politics
得不到恨之入「谷」紐媒狠酸「膽小鬼」	sports
國民黨成「萬惡淵藪」？前藍委槓寶可夢	politics
《財經觀測站》今日珠三角明日長三角	business
每年詐害全台上萬人今年吸金飆500億	society
陳鴻文加盟澳聯和林智勝成隊友	sports
APEC》我與多國雙邊會談力推產業合作	politics
馬來西亞「淨選盟2.0」獲頒亞洲民主人權獎	politics
「台銀週」票房破萬「達欣週」接棒搞演唱會	sports
酒駕男墾丁開民宿死者妻：不原諒	society
SBL》布拉「力」擒台銀賈西亞雙26白搭	sports
中國去槓桿明後年經濟成長走緩	business
LPGA封關戰艾莉雅逆轉封后	sports
過馬路突中風倒地險遭爆頭	society
犁田撞法拉利男大生慘死	society
奧會改選羅生門》中華奧會：IOC支持如期選	sports
當年簽約金460萬富邦釋出黃智培	sports
湖人設「球爸條款」媒體勿近	sports
保護王柏融埋伏2奇兵	sports
川普加持！博通併博科美政府兩週點頭	business
老師校園車震國中女被撞見	society
吳敦義批水利會改制「巧取豪奪」徐國勇︰國民黨昨是今非	politics
關貿網路攜手調查局打造資安防駭國家隊	business
台積電攜手工研院開發新技術兆晟可望成「漢微科第二」	business
正妹睡了朋友T恤穿反被男友抓包	society
召修型號未送修除濕機起火險釀災	society
專訪》經典賽沒幫冠宇守住郭俊麟痛哭道歉	sports
「首領」郭大砲到場問候子弟兵	sports
下週油價連4漲將創近3年新高	business
全國桌球錦標賽》16歲「神童」林昀儒男單封王	sports
HBL》「綠色神盾」衛冕軍1分險勝東泰	sports
金融帳連29季淨流出累計金額突破10兆元	business
前白宮官員︰美若撤對台承諾很危險	politics
鴿界證實陳慶男簡良鑑熱中賽鴿	politics
美學者︰共軍攻台最可能從桃園登陸	politics
不滿騎士按喇叭當街持刀砍他手	society
民進黨「英德」超級王牌合體帶頭衝	politics
冬盟》隊長猛打賞日職東軍奪冠	sports
貨櫃運輸逐步回溫淡季不看淡	business
焦點評論／繼續讓惡警耍流氓？	society
UBA》打球變打人經國球員道歉	sports
《大樂透》頭獎連6摃	society
克魯伯2度奪塞揚印隊首人	sports
爸爸撿到20元高中生代送派出所	society
日完封韓奪冠「復仇戰」等4年後	sports
郭文居當議員推動嘉市棒運	sports
台日青棒賽》度過亂流黃震武收服岐阜	sports
百萬象迷急凍不及格的9404人	sports
林德福帶頭衝最怕後面沒人跟	sports
今年部會遭彈劾人數教育部最多	politics
疑三角戀談判擦槍走火正牌男友中彈鬧跳樓	society
一週大事（11月12日至11月18日）	politics
妻小都在車上醉爸「倒退嚕」逃酒測	society
涉移民署弊案》內政部資訊中心主任施明德百萬交保	politics
有選手邊喝酒邊打球！辜董在說誰？	sports
一朗去運動家?殷仔獻上祝福	sports
比照公投／18歲開銀行戶顧立雄贊同	business
一週證券行情表、一週櫃檯行情表	business
CPR轟81分雷霆6連勝	sports
超商防搶守則深夜不多留現金	society
落跑人犯掛手銬趴趴走買檳榔	society
19年前亞青賽松坂、郭泓志上演火球對決	sports
黑道勾統促黨／陪唱「色」局竹聯幫孝堂逼學狗爬勒索	society
洋基誘因太強金鶯想送出馬查多	sports
男抽搐昏倒自強號上同車醫一路CPR搏死神	society
NBA》籃網主力歸隊林書豪板凳助陣	sports
證券行情表、證券表格	business
女爛醉被「種草莓」酒後問罪慘遭性侵	society
併購帶動封測業後長華董座：中國將併購材料廠	business
爭取大谷翔平水手、藍鳥表態	sports
台日截480kg安毒日警來台贈謝狀	society
「憲」場直擊》情蒐和後勤最棒幫手	sports
嬤扛重擔養重殘兒與5歲孫	society
防彈總統座車運抵月底交車	politics
肯亞詐騙案44台嫌中國全判刑	politics
喜宴白吃母女霸屋遭斷電趕不走	society
夫妻吵架警到場妻突墜樓亡	society
冬盟》鄉長指叉球王鴻程偷學	sports
中信公開賽今開打盧曉晴曬恩愛	sports
MAZDA台日青棒賽》怪投林奕丞關門興大附農險勝大阪	sports
青棒揮木棒恰恰有條件支持	sports
謠言終結站》政府花20億養移工孩子？勞動部︰只有幾百萬	politics
柯文哲︰發敬老金是買票	politics
酒駕鞭刑伺候?法部下月討論	society
搶超商店員殭屍跳檳榔富少迷網遊父痛斥進監反省	society
國台辦：李明哲犯罪事實清楚	politics
超夯日劇帶動日本威士忌熱銷	society
韓教頭真情剖白：台灣棒球10年沒進步	sports
台電停電預測賽冠軍組準確率達6成	business
改練空架雪車江俊弘拚冬奧門票	sports
《書劍集》英國脫歐的意外與命運	business
拜拜線香燙到女臉要10萬整形難和解	society
為愛開球曾仁和緊張	sports
夏普助攻鴻海Q3獲利回溫	business
嘿咻後傳訊老公早安告男友性侵不起訴	society
核四燃料棒規劃明年Q2輸出	business
神達車聯網收割獲美政府車隊訂單	business
中國獎學金申請要求台生認同一中	politics
富邦不老勇士GO來盃昔日名將同場拚	sports
黨產會清查救國團資產達55億	politics
查涉犯公司法案件調局全國大掃蕩	society
帶青棒太燒腦王光輝嘆「不簡單」	sports
《感到痛心》二哥︰弟長期家暴自毀家庭	society
「持續」暴力滋擾統促黨恐涉組織犯罪	society
想要回報洪總陽岱鋼亞冠賽助拳	sports
親友勸念大學邱丹別有牽掛	sports
史坦頓奔洋基兩全壘打王暴力合體	sports
誰開我的車？酒駕撞死女騎士裝傻	society
基本工資3萬？賴揆：徒法不足以自行	business
代工廠產能滿載MOSFET下單得等2個月	business
新制勞退基金收益創高每戶帳上增加萬餘元	business
博崴爸媽︰有關鍵錄音促加強搜救機制	society
台3線獅潭段過彎摔車重機男頸椎骨折亡	society
10月台幣REER連5降創1年新低	business
警攔查遊覽車司機酒駕乘客從抱怨掃興變感恩	society
防被攔截台積電南京廠關鍵資訊不落地	business
清晨4點就穿好球衣太巴塱球員超嗨	sports
公司派5董2監被解任友旺司法戰開打	business
備戰亞冠賽陳冠宇：先發2場沒問題	sports
藍綠若打不出好牌柯Ｐ就聽牌	politics
SBL熱身賽》混血射手發飆金酒收首勝	sports
40歲卡特還能飛奪24分氣走大帝	sports
謠言終結站》輪班間隔縮為8小時？行政院︰例外非原則	politics
雇主少給薪最重罰一百萬	society
促撤草案勞團：反對勞基法修法	business
與兄吵完架妹回老家浴火成焦屍	society
世界盃資格賽》打速度戰李愷諺獲青睞	sports
《財經觀測站》比特幣的崛起與風險	business
王令麟賣了東森電視股權茂德接手	business
稅改過關倒數川普耶誕前送禮	business
車用面板放量凌巨今年EPS估逾1.5元	business
「薪」亮點》倪福德情況有點「複」雜	sports
葉俊榮︰排黑條款不讓他們在那亂	politics
雙K合攻61分勇士8連勝	sports
金酒港都主場週「小郭雪芙」當嘉賓	sports
無線充電模組市佔提高台郡看好	business
百感交集徐：自由無法用錢衡量	society
單週MVP魔咒台銀明拚破解	sports
《國際現場》美政府主動查中國鋁板傾銷	business
美科技股重挫拖累亞股下跌	business
台銀人壽今年續虧40億呂桔誠：3年內可落底	business
日本一》橫濱行不行?0勝3敗後逆轉勝	sports
法部研修監獄行刑法受刑人將享通信隱私	society
拉下璞園賈西亞僅用8成功力	sports
盧曉晴、「恰恰」較桿寒冬送暖	sports
酸轉職退伍軍官雙薪肥貓不算侮辱	society
保全蠟燭3頭燒／日上12小時還要顧病妻、稚女	society
連3場破20分魯比歐「封爵」攀高峰	sports
用磁磚撥氣窗色狼偷窺女洗澡	society
踢走全家統一超商入主松機國內線商場	business
殷仔日文程度和表現成正比？	sports
金管會擬修法金融業獨董席次須過半	business
亞冠賽》征台是最後任務莊勝雄言退	sports
蔣砲隨林智勝赴澳?10日就知道	sports
忘情喇舌擋路引爆20人大亂鬥	society
電競、比特幣加持動力年底上市	business
大貨車國道翻覆連撞11車6傷	society
「憲」場直擊》對比日韓游擊臂力差一截	sports
護照出包印製廠︰概括承受	politics
雷倩多次溝通辜嚴態度軟化	politics
雷霆又卡卡「甜瓜」成輸球箭靶	sports
中職風波胡智為：自律最重要	sports
毛警官＋空拍機3D監控包抄逮毒犯	society
球探報報》「不世出天才」大谷單季有30轟實力	sports
學者：台灣難簽FTA95％因為北京	politics
新聞分析》林佳龍迎戰政績當後盾	politics
丟浴缸想滅證詐團沒想到iPad防水	society
警抄賭場赫見警備隊員也在裡面	society
錢珮芸「放掉情緒」衝到第9	sports
美聯二壘手銀棒獎艾圖維4連霸	sports
大聯盟人瑞級球員柯隆、一朗待業中	sports
廢棄倉庫大火黑煙遮蔽高雄港	society
光寶全球大擴廠	business
以氣補煤大潭電廠污染超標	business
民眾申請加入協會足協羽協人數超越棒協	sports
斧頭雙盜劈銀樓秒搶80萬金觀音	society
中國駐美公使嗆武統陸委會：狂妄蠻橫	politics
越南新廠延後投產儒鴻目標價大調降	business
入札制度談不攏大谷恐延後赴美	sports
亞錦賽》林盈馨硬拚欲速不達	sports
「協助辦案」嬤被騙當車手押29天才洗刷清白	society
陳偉殷暫時搭不上「大谷熱」	sports
TJ後還能簽大約陳偉殷史上第5強	sports
美學者沙特：對台政策川普可能更有作為	politics
踢倒東帝汶台男足迎主場4連勝	sports
少棒趕場5大賽一個月奔波2000公里	sports
一、二線網戰部隊未串接影響戰力	politics
撞車獲救爬回山谷找回錢再就醫	society
HBL今開戰列強重新洗牌	sports
中國頂超賽戴后、小天雙雙逆轉秀	sports
嬰屍放水流…醫院、葬儀社皆觸法	society
龍獅虎象傳奇對決今明重映	sports
蔡總統：嚴密監控共機採必要措施	politics
焊接槽車破洞引氣爆男炸飛亡	society
洋蔥網路小檔案》匿蹤手法駭客躲追查	society
王鴻程放下行李就做重訓	sports
美津濃馬拉松接力賽清大破紀錄摘冠	sports
被校長問倒張育成重返棒球路	sports
3年前曾自殘警耶誕躲廁所自殺	society
魏少絕殺落空大三元留憾	sports
越級打怪青棒打經典賽球	sports
世界盃亞洲區資格賽》紐利寶刀未老實力「澳」視亞洲	sports
勇士依舊猛猛的最快週六迎回萌神	sports
冬盟》比賽老輸1分林振賢：差在基本功	sports
USTR副貿易代表懸缺／今年台美TIFA停開他國也延宕	business
宏達電再出發領先推半透明3D水漾玻璃手機	business
巨人補強砸1.2億簽野上亮磨	sports
海碩盃》搭檔生病詹謹瑋無力回天	sports
動輒得咎進退失據	business
威力彩頭獎連2摃	society
葛瑞芬慶祝回歸湖人當祭品	sports
拿到世界冠軍貝爾川滿足退休	sports
防邏輯炸彈機敏單位應嚴禁ＭＩＣ	politics
全家超商結盟創業家兄弟冷凍食品店取搶商機	business
《國際現場》那斯達克傳明年推比特幣期貨	business
奧運2度輸台灣杉浦為拚金拒職棒	sports
與高通合作停擺發展小基站工研院另尋合作對象	business
傾聽被害人心聲法界肯定	society
鄭錡鴻經驗談催速度也要防護	sports
蔣浩文超水準救援高苑抵8強	sports
2歲女童誤轉油門母女撞進藥局	society
財經觀測站》賴揆掃雷	business
禿鷹炒奧斯特檢調大搜索	society
追靚警被控性騷擾男警嗆：我會開槍	society
立院三讀國家人權館可望明年掛牌	politics
悅康藍牙傳輸專利獨步全球	business
搜救幻象飛官邀商水下打撈	politics
因為龍紋身少棒商品熱賣21萬元	sports
火箭2連敗勇士當西部一哥	sports
《大樂透》頭獎連8摃	society
為台投開藥方日投教：善用下半身	sports
殷仔續留馬林魚3年可領19.7億	sports
放棄封王遊歐王柏融月底赴美「深造」	sports
日本隊主力在冬盟「還不快情蒐」	sports
抓藏鏡人警方請國際刑警協助	society
《國際現場》嫌利潤低印度零售商停賣iX	business
外送員甘苦談還是以客為尊	society
財經觀測站》機器人理財勿不切實際期待	business
威力彩頭獎連3摃	society
景氣掉黃藍燈「復甦動能不夠強」	business
財源爭議多勞軍捐最大條	politics
半導體明年看好世界先進擬投資12吋廠	business
沿用「太平洋」商標SOGO董座黃晴雯被訴	business
聯發科作證舉發公平會速罰高通	business
謠言終結站	business
堵中傾銷歐盟改祭「市場扭曲」新規	business
吳經國質疑舊民意我奧會改選應延期	sports
偶數日現金回饋2%聯邦銀行明年續辦	business
聖露西亞總理來訪我軍禮歡迎	politics
北市長推會贏的人？》殘酷的現實…人選依舊無解	politics
除暴特勤隊開紅盤逮擁槍角頭	society
檢再傳陳慶男父子與簡良鑑詐貸部分擬年底前先偵結	politics
崇越願給機會林志祥月薪剩1/7?	sports
徐生明盃4強出爐3隊新面孔	sports
青商會長開地下錢莊潑糞潑漆逼債	society
冬盟》4長打4打點曾陶鎔稱運氣好	sports
慶富保證金後天將再沒收近17億	politics
賓士男酒駕撞人不甩哀求輾死肇逃	society
國民參審制內容摘要	society
社區保全疑餵藥猥褻女童	society
聯邦銀促銷刷卡送鍋具	business
人權博物館明年517掛牌	politics
壽險爆裁員友邦300人、南山150人	business
南投79大山禁獨攀嚮導︰結伴登山較安全	society
「投」身教學5天助教建仔費思量	sports
軟銀球星柳田悠岐：王柏融快來日職吧！	sports
聽法會領千元藍遭質疑綁樁	politics
SBL明開打機票、手機「禮讚」球迷	sports
走私斷片兒酒2公司被抓包	society
提升三振率江少慶滑球出籠	sports
遊覽車擦撞機車輾斃7旬婦	society
外交官偷歡1年50次女方行事曆成鐵證	society
慶富交船延宕海巡署解約求償12億	politics
假健保局誆匯款婦700萬險遭騙光	society
幻象打撈廠商出爐將視海象出海作業	politics
生日攜毒被逮警播歌慶生勸戒毒	society
簽約和解林峯正︰不再追認附隨組織	politics
女童遭猥褻胸罩驗出父兄DNA	society
父持衣架毒打還猛踹5歲「紙片女童」遭虐死	society
HBL》國產車拚贏保時捷治平奪隊史預賽首勝	sports
立委提案修兩岸條例刪「國家統一前」字眼	politics
連2天持8刀闖校園清秀女衝教室割傷學童	society
DeNA2連勝日職第4支絕地大逆轉？	sports
終止連4漲汽柴油回跌3、4角	business
女控前男友綑綁強押性侵	society
富邦長春公開賽》鈴木亨獨走呂文德落後一桿	sports
特定協會入會／足協破萬人泳協躍居第2	sports
又來了中國三軍機繞台演訓	politics
120萬落車上運將早一步送招領	society
南山「改版鐵三角」衝出複賽2連勝	sports
盧秀燕控不知利益迴避鄭麗君斥惡意中傷	politics
參審制可訂刑度陪審制只判有罪否	society
國民黨喊窮吳敦義對外借款1.4億	politics
誰是相公？藍營點名馬「胡」不了	politics
失聯幻象海底發出黑盒子訊號	politics
阿部2000安達陣陽岱鋼︰還要更努力	sports
馬林魚第一波精實名單沒有陳偉殷	sports
「耶誕大戰」看不到柯瑞？！	sports
超級搖頭丸W飯店小模為此喪命	society
金錢豹酒女3度酒駕撞死逐夢主廚	society
小6女童為300點數裸拍影片慘遭轉PO	society
果真是媽寶！25歲鐵工酒駕撞護欄找媽頂罪	society
酒駕載美眉撞樹害她頭碎3塊慘死	society
徐生明盃／韓隊賽後一鞠躬有洋蔥	sports
教士宋文華等待登板機會	sports
SBL季前系列報導》補強後場戰力裕隆直指金盃	sports
台灣大攜手富邦銀推智慧支付富邦旺紅包	business
「憲」場直擊》中職球隊少打者沒機會磨	sports
違停還辱罵白癡飛車女拖行俏女警	society
SBL》拉莫斯飆34分金酒大勝裕隆	sports
中職》悍將重訓營開課初步溝通「薪」事	sports
《財經觀測站》假如國產車沒了	business
群創花314億向鴻海買下LTPS廠設備	business
約炮約到偽娘劫財不劫色挨告	society
SBL》返金酒重回高峰張容軒少了自我	sports
行政訴訟創舉影音取代筆錄	society
李大維：台索邦誼不變總統行程照走	politics
2樓變6樓超級違建二房東餵毒囚外勞	society
陳偉殷棒球營美日訓練兼具	sports
奉獻公益雷倩︰婦聯會老店可以新開	politics
大福彩頭獎連53摃	society
陽岱鋼來教球五峰國小嗨翻了	sports
東泰高中拚外卡交給攻蛋嗨咖	sports
進40人名單張育成「大」有可為	sports
證交所公司治理評鑑強化董事會職能	business
「二刀流」話題夯陽岱鋼：青棒可先試工具人	sports
中職》中信「棄將」變富邦「悍將」？葉總有名單	sports
P-3C反潛機今成軍	politics
抓猴失敗徵信社判退款145萬	society
王柏融年薪支出阪神精算中	sports
逮回女毒蟲偷溜新北刑大疏失懲2人	society
成立棒球學校？建仔經紀人：順其自然	sports
中國科技巨擘淪政府監控幫手	business
富邦長春公開賽》逆風一桿進洞呂文德躍排頭	sports
威州設廠簽約鴻海「美國製造」啟動	business
大樂透頭獎連4摃	society
「殺了你好嗎？」慈悲殺癱兒父獲輕判	society
焦點評論》勞資合意要玩真的	business
井口監督第一勝感想：忙	sports
中和大火9死找警補破網查房基層大反彈	society
蔣萬安選北市長？馬吳都笑而不答	politics
個人造業個人擔！塞軍KO厄文贖罪11連勝	sports
切入觸控鍵盤奇鋐明年比今年好	business
樂天有心豪哥重拾43號	sports
《高風險家庭》9次通報未能阻悲劇	society
年終賽》輸給依瑟儂小戴衛冕拉警報	sports
SBL》300公斤壓場布拉勝塞勒	sports
共軍機群穿越巴士海峽切入我防空識別區	politics
宇峻今年EPS估4元明年推14款遊戲	business
世界盃資格賽》對抗澳客陳冠全扛重擔	sports
《國際現場》數位貨幣市值蒸發1600億美元	business
7奈米明年需求強勁台積中科擴增3廠區	business
伊諾肝素鈉針劑訂單國光獲追加	business
在校遭性侵11歲少女愛上狼師	society
闖民宅抓寶可夢男被打到骨折	society
兩岸合編國文教材台灣多校採用	politics
母女白吃鬧婚宴詐欺送辦	society
日職5年磨雙刀大谷「美」夢更踏實	sports
許一個璀璨句點…增菘瑋告別職棒	sports
律師觀點：受害者若不只一人就有「詐」	society
未查出曾收陳慶男獻金民進黨道歉	politics
中國輝山乳業清算永豐金踩雷	business
國際現場》宣布停產OZO諾基亞退出VR市場	business
罷昌案今對決罷免門檻63888	politics
駕法拉利總座賣「掃地機器人」大翻身	society
戴草帽騎車野戰阿伯栽了	society
中製鞋靴我啟動反傾銷落日調查	business
末節強攻11分張宗憲灌倒台啤	sports
9號球世錦賽》我唯一晉4吳坤霖誓破老二魔咒	sports
顧立雄︰拉高外資稅負恐爆匯出潮	business
破局內幕》婦聯會鷹派常委拒簽行政契約	politics
台北國際城市青少棒賽》冬天就變弱馬公慘遭淘汰	sports
選前LINE傳民調連結違法裁罰50萬	politics
《殺警案》檢不提上訴鄭性澤無罪定讞	society
慶富︰國防部片面解約不合法	politics
亞冠賽「韓」恨潘忠韋︰缺臨門一腳輸得可惜	sports
朱俊祥不休戰藉冬盟加強控球	sports
SBL》蔡文誠飆破3000分「贏球更有感」	sports
台積電連兩天重挫市值蒸發1個股本	business
打敗東霸天爵士付出代價大	sports
什麼都賣／女朋友販賣機買禮物送正妹LINE	society
歐洲5財長聯名反對川普稅改案	business
新零售革命線上線下整合	business
功德院模仿犯男塗鴉北車挨首罰	politics
德最大風機廠在台設亞太總部	business
成台灣No.1！鄭怡靜一日4喜	sports
性侵發出痛苦聲就殺姦殺女童惡狼免死	society
台日青棒賽》吳聖紘臨危不亂千葉監督按讚	sports
SBL》賈西亞不孤單台將助拳、台酒止敗	sports
高通高級總監︰5G是VR重要的未來	business
一週大事（11月19日至11月25日）	politics
賴揆肯定窒息式掃毒盼6守護神並肩作戰	society
歐洲央行︰全球金融市場面臨回檔	business
竹北分局門面龍柏1綠1枯黃狀況連連人心惶惶	society
遇熊自保之道／慢慢後退安靜離開	society
中信震撼彈釋出蔣砲等7人	sports
SBL》中鋒轉後衛王泰傑惦惦做工	sports
亞冠賽情蒐備戰「我們也不弱」	sports
中職今年度頒獎7冠「王」成焦點	sports
用前所長章補開三聯單警吃官司獲不起訴	society
護照風波》中央印製廠總座陳永輝記申誡	politics
yes123調查︰一例一休人事成本增加影響今年年終服務業衝擊最大	business
下鄉座談賴揆：加強中央、地方合作	politics
曾仁和大聯盟發光建仔：像看到小孩長大	sports
雞雞短小刺不破處女膜	society
本業停滯？鴻準投資57億入股IDG	business
慶富幫吐瓦魯造船爆扣船私貸9億	politics
世界盃資格賽》抗菲靠外線呂政儒有經驗	sports
不只抗颱離岸風機也要耐震	business
保單當定存賣金管會出手遏止	business
柯旻豪義助小斌才能立大功	sports
傷後復出奪冠小戴歸功長庚	sports
國銀Q3對中曝險微增永豐銀逼近警戒線	business
資產逾兆銀行須設獨立法遵	business
一句「小孩哭著找媽媽」少女澆熄色狼慾火	society
文件夾拍臀護理師告贏色醫	society
古錐童星長大後…涉殺人還變身詐騙首腦	society
葉俊榮︰婦聯會還活在大宅門裡	politics
除了一軍廖任磊盼飆破160公里	sports
失業工人當車手才幹10天就被逮	society
「協助辦案」嬤被騙當車手押29天才洗刷清白	society
座車公器私用雲林消防局長認了	society
金融科技園區兩年後落腳北市後山埤	business
澳聯》3台將明星賽合體張泰山敲勝打	sports
即使買到F-35戰機國造不中斷	politics
瘦弟酒駕胖哥頂罪	society
婦聯會拒交帳冊行政契約簽不成	politics
賴揆：提升總統支持度是我的工作	politics
台灣300億市場餐飲集團搶「鍋」	business
一週大事（12月3日至9日）	politics
提升幻象妥善率明年50億籌補零附件	politics
60人大名單明拍板大餅將轉教練	sports
證券行情表、證券表格	business
新聞幕後》「不惜辭官」陳吉仲全力推改制	politics
香港羽球超級賽》決賽對手難打戴資穎今拚連霸	sports
馬術金牌偕女出擊0扣分奪冠	sports
張綱維取得三信5席董事金管會將要求說明	business
對拒測者強制抽血須檢同意	society
講真的？饒穎奇：中共有心建立人民民主	politics
與民間合組公司「技術合作」中科院︰絕不規避國會監督	politics
亞冠取經林樺慶「無緣的結局」	sports
19大後中國軍機4度近台日戰機升空	politics
手指脫臼照拚34分拉莫斯獲「單週最佳」	sports
SBL開幕日霸主達欣12/2尬裕隆	sports
客戶美律砍價康控跌停	business
《民俗方法》掃一遍凶車燒掃把去霉運	society
出版新書陳菊：同志不快很抱歉	politics
哥倫比亞盜寶集團鎖定珠寶展四處犯案	society
台塑四寶看營收Q4要比Q3好	business
資產逾兆銀行須設獨立法遵、資安	business
財委會調閱小組從文件找真相︰獵雷艦案「一再死了又生」很奇怪	politics
二刀流大谷終將改走「強投」路?	sports
矽晶圓供需沒雜音明年訂單仍旺	business
強化洗錢防制賴揆週三誓師	politics
澳聯明開打張泰山球員終點站？	sports
西武閉門羹松坂回不去了	sports
美稅改最終版公布可望過關	business
巧手消防員無師自通變木工達人	society
澳職今年首打點林智勝締造	sports
microLED新商機法人：市場恐過度樂觀	business
金門國家公園套幣16日開賣	business
藝人岳父驚爆在托兒所狎女童	society
職棒傳奇OB賽陽介仁抗癌扛先發	sports
台彩威力盃》二刀流＋上下並用屏東險吞桃	sports
財經觀測站》蓋營運總部會有魔咒	business
妻和男客赤裸在床告不成通姦	society
抄進階版搖頭丸劇毒可害25萬人	society
五月天再當代言人宏達電：挺夠意思	business
李明哲案今宣判》陪李凈瑜赴中王麗萍被驅逐出境	politics
「傳奇」龍虎鬥寶刀「不老」	sports
隔壁阿公性侵害女童長菜花	society
HBL》木柵高工奪隊史首勝首度打進12強	sports
搶死人生意?4煞砸爛7殯葬車	society
廁所偷拍終結者女網友半年同地揪2案	society
郭建宏/不想回頭轉戰科技業生活穩定	sports
陳瑞振換跑道坦言不習慣	sports
中國羽球頂超賽》小戴小天晉8今雙雙遇難關	sports
台股股后爭奪戰精華盤中擠下精測	business
台北城市盃日本大阪奪冠	sports
律師說法／時空膠囊屬學生所有	society
世足賽》亞洲球隊搶勝球評：日本或有機會	sports
選秀靠伯樂中職3隊2球探起跳	sports
社會人棒球先生西鄉拒絕職棒	sports
磊晶缺貨客戶要貨只能給一半	business
誤飲摻藥飲料四肢無力夫硬上挨告	society
高中生打職棒胡金龍鼓勵旅外	sports
《財經觀測站》陳家班的董事長練習場	business
自提北市長人選？民進黨還在觀望	politics
董娘臨終託女照顧員工感恩投水陪葬	society
明年都更催油門房產業質疑	business
「柯瑞障礙」添紀錄最速「2000顆三分球」	sports
華帥「打強心針」湖人逆轉公牛	sports
加速重大開發案審議拚1年完成	business
許銘倢/重新歸零月領3萬照樣有夢	sports
喝花酒性招待台鐵7劣官二審輕判	society
交通壅塞印度也推共享單車	business
蒐集經血毛巾最強正宮逼小三認栽	society
馬英九訪美將赴南加大演講	politics
新紡董事內訌防堵吳東進發聲	business
台塑汽油週一起降1角	business
打造「悍將的家」富邦砸逾億「換臉」	sports
有事大哥扛！詹皇、魏少飆大三元搶勝	sports
香港羽超賽》戴資穎今登場挑戰2連霸	sports
罷昌案門檻同意票數63888票	politics
IKEA疑避稅荷蘭歐盟啟動調查	business
追了5年遭拒洋基黯然神傷	sports
證券行情表、證券表格、上市櫃公司十月營收表	business
新台幣全年升值8％近卅年最高	business
穀保非典OB賽陳冠宇太搶戲被虧	sports
世界盃亞洲區資格賽／明戰狂野菲律賓護球是關鍵	sports
離岸風電遴選「國產化」先不評比	business
世界人才報告排名23ＩＭＤ示警︰台灣留才攬才欠佳	business
快40歲練二刀流?火星恰棒球營將登場	sports
彭愛佳聲請解除境管檢︰上街問路人誰認為妳無罪？	politics
SBL》金酒拉莫斯雙廿壓垮璞園	sports
HBL》陳芷英全能秀普門開紅盤	sports
教國軍招募舞中士襲胸「頂」美女士官	society
大帝洛夫雙十「劫」騎士4連敗	sports
11/30威力彩頭獎連26摃	society
強化洗錢防制…政院通過國際刑事司法互助法草案	society
婦聯會拒交帳冊為保「金雞母」	politics
大樂透頭獎連15摃	society
少女控告性侵大片刺青還他清白	society
黑豹旗MVP戴培峰想拚中職	sports
媽媽遺體才運回家逆子馬上盜2筆存款	society
謝秉洋、林哲揚障礙馬術團體奪冠	sports
陽岱鋼維持3億日圓回台做「冬訓」	sports
不逃脫馬林魚合約殷仔避免傷害自己	sports
戴正吳培養接班人擬設共同執行長	business
以竹聯、白狼之名嗆課審委員給你死	society
萬金石馬拉松升級「銀標」賽事	sports
戰勝心魔張耿豪年度最有「進」	sports
蘇憲丕子︰盼父親犧牲能改變制度	society
NBA傳奇球星活動》裴頓說故事巴特勒教球	sports
海碩盃地主球員首輪全掛史上最慘	sports
量縮盤整台幣微貶0.1分	business
領完金球贏球C羅設「5連勝」障礙	sports
甜瓜回娘家激情過後GG了	sports
疑犯逃竄釀4傷警「見死不救」	society
徐生明盃》徐生明盃少棒賽台日韓到齊	sports
星期專訪》政務委員林萬億：擴大托育照顧提高生育率	politics
女警盯女毒蟲採尿檢體離奇女變男	society
台日青棒賽》191公分「巨」投穀保主力接班人	sports
蘋果非蘋訂單雙吃燿華旺到明年Q1	business
厄文扛綠衫軍6年半來首勝馬刺	sports
陳菊出書掀當年初選恩怨	politics
長這樣有錯嗎？樹幹「反擊」鋸樹翁	society
最佳教練賴建誠沒有他就沒有戴后	sports
冬盟》加強長打梁家榮盼扛決勝	sports
出訪菲律賓、泰國吳敦義︰免簽應相互尊重	politics
逾3萬人迎「猿王」史上最轟動	sports
被指脫模說法兜不攏海軍要告媒體	politics
阪神呂簽複數約發出能見宣言	sports
涉與中國普天假交易華美電三高層聲押	business
SBL季前戰力分析》戰力補強到位璞園奪冠熱門	sports
全民挺體改戴后首度發表政見	sports
電價漲不漲？月底可望拍板	business
17年愛情告吹女討奉獻費敗訴	society
2019世界12強賽台韓墨主辦預賽	sports
台泥國際私有化20日生效台泥發行5.54億新股	business
台灣股票博物館導入AR	business
斷不開的小三！男猝死兒女追打按摩女	society
